year,state,gender,false,true,total,%
1910,AK,F,44,24,68,35.294117647058826
1910,AK,M,26,21,47,44.680851063829785
1910,AL,F,11436,1666,13102,12.715615936498246
1910,AL,M,5024,1579,6603,23.913372709374528
1910,AR,F,6604,935,7539,12.402175354821594
1910,AR,M,2783,720,3503,20.553811019126464
1910,AZ,F,473,113,586,19.283276450511945
1910,AZ,M,355,133,488,27.25409836065574
1910,CA,F,5271,679,5950,11.411764705882353
1910,CA,M,2474,740,3214,23.024268823895458
1910,CO,F,2082,389,2471,15.742614326183732
1910,CO,M,864,274,1138,24.077328646748683
1910,CT,F,2560,612,3172,19.293820933165197
1910,CT,M,882,458,1340,34.179104477611936
1910,DC,F,734,139,873,15.922107674684993
1910,DC,M,420,220,640,34.375
1910,DE,F,397,92,489,18.813905930470348
1910,DE,M,121,80,201,39.800995024875625
1910,FL,F,3541,486,4027,12.068537372734045
1910,FL,M,1918,675,2593,26.0316236020054
1910,GA,F,13741,1855,15596,11.89407540394973
1910,GA,M,6730,2278,9008,25.288632326820604
1910,HI,F,311,60,371,16.172506738544474
1910,HI,M,124,77,201,38.308457711442784
1910,IA,F,5021,695,5716,12.158852344296712
1910,IA,M,1807,367,2174,16.881324747010122
1910,ID,F,635,122,757,16.116248348745046
1910,ID,M,247,85,332,25.602409638554217
1910,IL,F,15807,2584,18391,14.05035071502365
1910,IL,M,6205,2054,8259,24.869838963554912
1910,IN,F,6067,1323,7390,17.90257104194858
1910,IN,M,2240,531,2771,19.162757127390833
1910,KS,F,4124,659,4783,13.777963621158268
1910,KS,M,1790,403,2193,18.376652986776108
1910,KY,F,9045,1594,10639,14.982611147664255
1910,KY,M,3468,1112,4580,24.27947598253275
1910,LA,F,8550,1158,9708,11.928306551297899
1910,LA,M,3640,1212,4852,24.97938994229184
1910,MA,F,8773,1757,10530,16.685660018993353
1910,MA,M,3192,1539,4731,32.53012048192771
1910,MD,F,3914,857,4771,17.962691259693987
1910,MD,M,1532,700,2232,31.36200716845878
1910,ME,F,1598,197,1795,10.974930362116991
1910,ME,M,546,130,676,19.230769230769234
1910,MI,F,7655,1019,8674,11.747751902236569
1910,MI,M,2762,634,3396,18.669022379269727
1910,MN,F,5208,629,5837,10.776083604591399
1910,MN,M,1945,404,2349,17.198808003405706
1910,MO,F,9480,1449,10929,13.258303595937415
1910,MO,M,3968,1012,4980,20.32128514056225
1910,MS,F,9157,1306,10463,12.482079709452355
1910,MS,M,4928,1511,6439,23.466376766578662
1910,MT,F,774,146,920,15.869565217391305
1910,MT,M,329,104,433,24.018475750577366
1910,NC,F,10884,1722,12606,13.660161827701096
1910,NC,M,4605,1879,6484,28.979025293028993
1910,ND,F,1895,256,2151,11.90144119014412
1910,ND,M,680,142,822,17.27493917274939
1910,NE,F,3046,450,3496,12.871853546910755
1910,NE,M,1173,262,1435,18.257839721254353
1910,NH,F,744,106,850,12.470588235294118
1910,NH,M,229,74,303,24.422442244224424
1910,NJ,F,7225,1421,8646,16.4353458246588
1910,NJ,M,2421,1250,3671,34.0506673930809
1910,NM,F,760,152,912,16.666666666666664
1910,NM,M,509,186,695,26.762589928057558
1910,NV,F,16,10,26,38.46153846153847
1910,NV,M,31,10,41,24.390243902439025
1910,NY,F,27797,4631,32428,14.280868385345997
1910,NY,M,10946,4785,15731,30.41764668488971
1910,OH,F,12544,2428,14972,16.216938284798292
1910,OH,M,4723,1431,6154,23.253168670783232
1910,OK,F,6421,854,7275,11.738831615120276
1910,OK,M,2625,610,3235,18.856259659969087
1910,OR,F,1219,154,1373,11.216314639475602
1910,OR,M,450,120,570,21.052631578947366
1910,PA,F,25209,6400,31609,20.247397893005157
1910,PA,M,9234,4377,13611,32.1578135331717
1910,RI,F,1090,255,1345,18.95910780669145
1910,RI,M,360,191,551,34.66424682395644
1910,SC,F,8043,1316,9359,14.06133133881825
1910,SC,M,3864,1760,5624,31.29445234708393
1910,SD,F,1548,218,1766,12.344280860702153
1910,SD,M,468,136,604,22.516556291390728
1910,TN,F,9043,1435,10478,13.695361710250047
1910,TN,M,3612,1191,4803,24.797001873828858
1910,TX,F,17316,1998,19314,10.344827586206897
1910,TX,M,7267,1808,9075,19.922865013774103
1910,UT,F,902,149,1051,14.176974310180782
1910,UT,M,340,103,443,23.25056433408578
1910,VA,F,9182,1600,10782,14.839547393804489
1910,VA,M,3713,1372,5085,26.981317600786625
1910,VT,F,588,93,681,13.656387665198238
1910,VT,M,208,61,269,22.676579925650557
1910,WA,F,2362,351,2713,12.937707335053448
1910,WA,M,979,237,1216,19.490131578947366
1910,WI,F,6059,745,6804,10.949441504997061
1910,WI,M,1971,434,2405,18.045738045738048
1910,WV,F,4875,844,5719,14.757824794544499
1910,WV,M,1558,442,2000,22.1
1910,WY,F,145,41,186,22.043010752688172
1910,WY,M,76,47,123,38.21138211382114
1911,AK,F,25,19,44,43.18181818181818
1911,AK,M,11,29,40,72.5
1911,AL,F,10426,1543,11969,12.891636728214554
1911,AL,M,4673,1611,6284,25.636537237428392
1911,AR,F,6300,859,7159,11.998882525492387
1911,AR,M,2667,796,3463,22.9858504187121
1911,AZ,F,558,116,674,17.210682492581604
1911,AZ,M,326,128,454,28.193832599118945
1911,CA,F,5784,818,6602,12.390184792487124
1911,CA,M,2675,707,3382,20.904790065050268
1911,CO,F,1969,374,2343,15.96244131455399
1911,CO,M,1000,307,1307,23.488905891354246
1911,CT,F,3455,747,4202,17.77724892908139
1911,CT,M,1814,892,2706,32.96378418329638
1911,DC,F,800,163,963,16.926272066458985
1911,DC,M,457,183,640,28.59375
1911,DE,F,429,97,526,18.44106463878327
1911,DE,M,181,89,270,32.96296296296296
1911,FL,F,3239,503,3742,13.442009620523784
1911,FL,M,1740,687,2427,28.30655129789864
1911,GA,F,13123,1891,15014,12.594911416011723
1911,GA,M,6663,2294,8957,25.61125376800268
1911,HI,F,391,93,484,19.214876033057852
1911,HI,M,164,82,246,33.33333333333333
1911,IA,F,5381,788,6169,12.77354514508024
1911,IA,M,2014,346,2360,14.661016949152541
1911,ID,F,768,140,908,15.418502202643172
1911,ID,M,325,105,430,24.418604651162788
1911,IL,F,16564,2827,19391,14.578928368830901
1911,IL,M,7004,2092,9096,22.999120492524185
1911,IN,F,6502,1374,7876,17.44540375825292
1911,IN,M,2701,721,3422,21.069549970777324
1911,KS,F,4711,677,5388,12.564959168522643
1911,KS,M,1969,395,2364,16.708967851099832
1911,KY,F,9314,1642,10956,14.98722161372764
1911,KY,M,3739,1063,4802,22.136609745939193
1911,LA,F,7908,1098,9006,12.191872085276483
1911,LA,M,3310,1029,4339,23.71514173772759
1911,MA,F,11297,2308,13605,16.964351341418595
1911,MA,M,6482,2763,9245,29.88642509464575
1911,MD,F,4045,866,4911,17.633883119527592
1911,MD,M,1871,777,2648,29.342900302114806
1911,ME,F,2047,262,2309,11.346903421394543
1911,ME,M,1128,263,1391,18.90726096333573
1911,MI,F,8265,1137,9402,12.093171665603062
1911,MI,M,2873,688,3561,19.32041561359169
1911,MN,F,5687,752,6439,11.678832116788321
1911,MN,M,2224,501,2725,18.38532110091743
1911,MO,F,9878,1558,11436,13.623644630989856
1911,MO,M,4314,1007,5321,18.92501409509491
1911,MS,F,8073,1106,9179,12.049242836910338
1911,MS,M,4332,1326,5658,23.435843054082714
1911,MT,F,934,167,1101,15.168029064486829
1911,MT,M,386,151,537,28.11918063314711
1911,NC,F,11058,1749,12807,13.656594050128836
1911,NC,M,5054,2015,7069,28.504739001273165
1911,ND,F,1957,297,2254,13.176574977817213
1911,ND,M,679,153,832,18.389423076923077
1911,NE,F,3275,453,3728,12.151287553648068
1911,NE,M,1371,260,1631,15.941140404659718
1911,NH,F,922,154,1076,14.312267657992564
1911,NH,M,563,184,747,24.63186077643909
1911,NJ,F,8384,1630,10014,16.27721190333533
1911,NJ,M,3746,1796,5542,32.40707325875135
1911,NM,F,861,163,1024,15.91796875
1911,NM,M,467,214,681,31.42437591776799
1911,NV,F,43,6,49,12.244897959183673
1911,NV,M,19,17,36,47.22222222222222
1911,NY,F,31725,5454,37179,14.669571532316631
1911,NY,M,16733,6900,23633,29.196462573520076
1911,OH,F,13852,2926,16778,17.43950411252831
1911,OH,M,6129,1686,7815,21.573896353166987
1911,OK,F,7049,918,7967,11.522530438056986
1911,OK,M,2775,672,3447,19.49521322889469
1911,OR,F,1375,201,1576,12.753807106598986
1911,OR,M,605,148,753,19.654714475431607
1911,PA,F,27637,6876,34513,19.922927592501377
1911,PA,M,12242,5838,18080,32.28982300884955
1911,RI,F,1372,312,1684,18.52731591448931
1911,RI,M,802,396,1198,33.0550918196995
1911,SC,F,7861,1243,9104,13.653339191564148
1911,SC,M,3972,1805,5777,31.244590617967805
1911,SD,F,1645,237,1882,12.592986184909671
1911,SD,M,693,129,822,15.693430656934307
1911,TN,F,8520,1456,9976,14.595028067361667
1911,TN,M,3549,1224,4773,25.644248900062856
1911,TX,F,17466,2058,19524,10.540872771972957
1911,TX,M,7301,1858,9159,20.28605742985042
1911,UT,F,1020,202,1222,16.53027823240589
1911,UT,M,414,124,538,23.04832713754647
1911,VA,F,9199,1511,10710,14.108309990662931
1911,VA,M,4250,1470,5720,25.699300699300696
1911,VT,F,748,146,894,16.331096196868007
1911,VT,M,430,86,516,16.666666666666664
1911,WA,F,2689,394,3083,12.779759974051249
1911,WA,M,1109,301,1410,21.347517730496453
1911,WI,F,6313,777,7090,10.959097320169251
1911,WI,M,2285,437,2722,16.054371785451874
1911,WV,F,5289,906,6195,14.624697336561743
1911,WV,M,1893,532,2425,21.938144329896907
1911,WY,F,185,59,244,24.18032786885246
1911,WY,M,95,42,137,30.656934306569344
1912,AK,F,60,22,82,26.82926829268293
1912,AK,M,38,21,59,35.59322033898305
1912,AL,F,13821,2009,15830,12.691092861655084
1912,AL,M,8184,2614,10798,24.208186701240972
1912,AR,F,8350,1148,9498,12.086755106338176
1912,AR,M,5022,1313,6335,20.726124704025256
1912,AZ,F,780,157,937,16.755602988260407
1912,AZ,M,665,258,923,27.952329360780066
1912,CA,F,8649,1154,9803,11.771906559216566
1912,CA,M,6564,1577,8141,19.371084633337425
1912,CO,F,2712,538,3250,16.553846153846155
1912,CO,M,2040,593,2633,22.521838207368024
1912,CT,F,4688,954,5642,16.908897554058843
1912,CT,M,3435,1593,5028,31.682577565632457
1912,DC,F,1058,215,1273,16.889238020424195
1912,DC,M,731,340,1071,31.746031746031743
1912,DE,F,600,164,764,21.465968586387437
1912,DE,M,390,207,597,34.67336683417086
1912,FL,F,4779,618,5397,11.450806003335186
1912,FL,M,3178,1119,4297,26.041424249476382
1912,GA,F,17244,2552,19796,12.891493230955748
1912,GA,M,10986,3665,14651,25.015357313493958
1912,HI,F,626,115,741,15.519568151147098
1912,HI,M,467,143,610,23.442622950819672
1912,IA,F,7894,1169,9063,12.89859869800287
1912,IA,M,5978,1076,7054,15.253756733768075
1912,ID,F,1103,202,1305,15.478927203065135
1912,ID,M,966,210,1176,17.857142857142858
1912,IL,F,24425,3801,28226,13.46630765960462
1912,IL,M,17441,4962,22403,22.14881935455073
1912,IN,F,9399,1972,11371,17.342362149327236
1912,IN,M,7428,1675,9103,18.40052729869274
1912,KS,F,6312,932,7244,12.865819988956378
1912,KS,M,4952,923,5875,15.71063829787234
1912,KY,F,11591,2037,13628,14.947167596125624
1912,KY,M,6894,1928,8822,21.85445477216051
1912,LA,F,10515,1415,11930,11.860854987426656
1912,LA,M,6277,1842,8119,22.68752309397709
1912,MA,F,14892,2926,17818,16.42159613873611
1912,MA,M,10629,4513,15142,29.804517236824722
1912,MD,F,5456,1194,6650,17.954887218045112
1912,MD,M,3769,1355,5124,26.444184231069478
1912,ME,F,2691,331,3022,10.953011250827267
1912,ME,M,1801,370,2171,17.042837402118842
1912,MI,F,11463,1634,13097,12.476139573948233
1912,MI,M,7311,1602,8913,17.973746213396165
1912,MN,F,8053,1076,9129,11.786614086975572
1912,MN,M,5733,1073,6806,15.76550102850426
1912,MO,F,13171,2060,15231,13.525047600288884
1912,MO,M,9050,2129,11179,19.04463726630289
1912,MS,F,10686,1474,12160,12.12171052631579
1912,MS,M,6813,2084,8897,23.423625941328538
1912,MT,F,1343,239,1582,15.107458912768648
1912,MT,M,978,313,1291,24.244771494965143
1912,NC,F,14730,2314,17044,13.576625205350856
1912,NC,M,8890,3325,12215,27.22063037249284
1912,ND,F,2823,368,3191,11.532434973362582
1912,ND,M,1832,409,2241,18.25078090138331
1912,NE,F,4932,669,5601,11.94429566148902
1912,NE,M,3991,632,4623,13.670776552022495
1912,NH,F,1234,211,1445,14.602076124567473
1912,NH,M,909,240,1149,20.887728459530024
1912,NJ,F,11557,2280,13837,16.4775601647756
1912,NJ,M,8222,3711,11933,31.098634040056982
1912,NM,F,1279,273,1552,17.590206185567013
1912,NM,M,876,296,1172,25.25597269624573
1912,NV,F,37,5,42,11.904761904761903
1912,NV,M,66,43,109,39.44954128440367
1912,NY,F,42330,7056,49386,14.287449884582676
1912,NY,M,30769,11922,42691,27.926260804385
1912,OH,F,18945,4029,22974,17.537215983285453
1912,OH,M,14145,3839,17984,21.346752669039144
1912,OK,F,8945,1153,10098,11.418102594573183
1912,OK,M,5946,1206,7152,16.86241610738255
1912,OR,F,2063,325,2388,13.609715242881071
1912,OR,M,1567,326,1893,17.22134178552562
1912,PA,F,36646,9145,45791,19.971173374680614
1912,PA,M,24586,10782,35368,30.48518434743271
1912,RI,F,2017,439,2456,17.87459283387622
1912,RI,M,1370,563,1933,29.125711329539577
1912,SC,F,10081,1662,11743,14.153112492548752
1912,SC,M,5986,2649,8635,30.67747539085119
1912,SD,F,2400,326,2726,11.958914159941306
1912,SD,M,1606,270,1876,14.39232409381663
1912,TN,F,11458,1856,13314,13.940213309298482
1912,TN,M,6657,2271,8928,25.436827956989248
1912,TX,F,23625,2702,26327,10.26322786492954
1912,TX,M,15081,3765,18846,19.977714103788603
1912,UT,F,1549,263,1812,14.514348785871963
1912,UT,M,1260,267,1527,17.4852652259332
1912,VA,F,12116,2053,14169,14.489378220057873
1912,VA,M,7184,2584,9768,26.453726453726457
1912,VT,F,1113,197,1310,15.038167938931299
1912,VT,M,762,130,892,14.573991031390134
1912,WA,F,3585,524,4109,12.752494524215138
1912,WA,M,2506,609,3115,19.550561797752806
1912,WI,F,9118,1099,10217,10.756582166976608
1912,WI,M,6198,1170,7368,15.879478827361563
1912,WV,F,6799,1166,7965,14.639045825486505
1912,WV,M,3910,1075,4985,21.564694082246742
1912,WY,F,257,60,317,18.92744479495268
1912,WY,M,254,73,327,22.32415902140673
1913,AK,F,39,21,60,35.0
1913,AK,M,23,27,50,54.0
1913,AL,F,14528,2153,16681,12.906900065943288
1913,AL,M,9449,3198,12647,25.286629240135998
1913,AR,F,8967,1206,10173,11.85491005603067
1913,AR,M,6204,1603,7807,20.53285513001153
1913,AZ,F,898,174,1072,16.23134328358209
1913,AZ,M,846,263,1109,23.715058611361588
1913,CA,F,10507,1353,11860,11.408094435075885
1913,CA,M,8337,1897,10234,18.53625170998632
1913,CO,F,3073,587,3660,16.038251366120218
1913,CO,M,2541,634,3175,19.968503937007874
1913,CT,F,5595,1222,6817,17.92577380079214
1913,CT,M,4224,1888,6112,30.89005235602094
1913,DC,F,1171,258,1429,18.054583624912528
1913,DC,M,783,386,1169,33.0196749358426
1913,DE,F,652,160,812,19.704433497536947
1913,DE,M,471,249,720,34.583333333333336
1913,FL,F,4791,727,5518,13.175063428778543
1913,FL,M,3570,1206,4776,25.251256281407038
1913,GA,F,17940,2694,20634,13.056120965396916
1913,GA,M,12337,4134,16471,25.09865824782952
1913,HI,F,790,114,904,12.610619469026549
1913,HI,M,609,194,803,24.159402241594023
1913,IA,F,9255,1372,10627,12.910510962642327
1913,IA,M,7761,1354,9115,14.85463521667581
1913,ID,F,1429,266,1695,15.693215339233038
1913,ID,M,1212,277,1489,18.603089321692412
1913,IL,F,28441,4638,33079,14.020980077995102
1913,IL,M,22270,6037,28307,21.326880276963294
1913,IN,F,10819,2392,13211,18.106123684808114
1913,IN,M,8738,2019,10757,18.769173561401878
1913,KS,F,7404,1159,8563,13.534976059792129
1913,KS,M,6195,1173,7368,15.920195439739413
1913,KY,F,13247,2400,15647,15.338403527832812
1913,KY,M,8297,2343,10640,22.020676691729324
1913,LA,F,10740,1397,12137,11.510257889099448
1913,LA,M,7047,2025,9072,22.321428571428573
1913,MA,F,17027,3387,20414,16.591554815322816
1913,MA,M,12482,5117,17599,29.07551565429854
1913,MD,F,5944,1224,7168,17.075892857142858
1913,MD,M,4238,1614,5852,27.58031442241969
1913,ME,F,2882,346,3228,10.718711276332094
1913,ME,M,2134,479,2613,18.331419823957138
1913,MI,F,13819,1886,15705,12.008914358484558
1913,MI,M,9613,2151,11764,18.28459707582455
1913,MN,F,9501,1186,10687,11.09759520913259
1913,MN,M,7598,1453,9051,16.05347475417081
1913,MO,F,14663,2326,16989,13.691211960680441
1913,MO,M,11387,2581,13968,18.477949599083622
1913,MS,F,10873,1632,12505,13.05077968812475
1913,MS,M,7757,2351,10108,23.25880490700435
1913,MT,F,1833,305,2138,14.265668849391954
1913,MT,M,1456,447,1903,23.48922753547031
1913,NC,F,15986,2546,18532,13.738398445931363
1913,NC,M,10424,3846,14270,26.95164681149264
1913,ND,F,3128,418,3546,11.787930062041738
1913,ND,M,2462,479,2941,16.286977218633115
1913,NE,F,5434,756,6190,12.21324717285945
1913,NE,M,4926,871,5797,15.025012937726409
1913,NH,F,1493,219,1712,12.792056074766355
1913,NH,M,1068,338,1406,24.039829302987197
1913,NJ,F,13199,2454,15653,15.677505909410336
1913,NJ,M,9293,4252,13545,31.39165743816907
1913,NM,F,1332,244,1576,15.48223350253807
1913,NM,M,988,356,1344,26.488095238095237
1913,NV,F,97,32,129,24.8062015503876
1913,NV,M,93,46,139,33.093525179856115
1913,NY,F,47222,7831,55053,14.22447459720633
1913,NY,M,34755,13543,48298,28.040498571369415
1913,OH,F,22540,4793,27333,17.53557970219149
1913,OH,M,17313,4759,22072,21.561254077564335
1913,OK,F,10203,1350,11553,11.685276551545053
1913,OK,M,7277,1538,8815,17.447532614861032
1913,OR,F,2258,346,2604,13.287250384024576
1913,OR,M,2007,409,2416,16.928807947019866
1913,PA,F,41643,10467,52110,20.08635578583765
1913,PA,M,29046,12808,41854,30.601615138338033
1913,RI,F,2188,474,2662,17.806160781367392
1913,RI,M,1682,712,2394,29.741019214703424
1913,SC,F,10723,1745,12468,13.995829323067053
1913,SC,M,6843,2965,9808,30.230424143556277
1913,SD,F,2734,350,3084,11.348897535667964
1913,SD,M,2142,406,2548,15.934065934065933
1913,TN,F,12409,2101,14510,14.479669193659545
1913,TN,M,8072,2637,10709,24.624147912970397
1913,TX,F,26578,3246,29824,10.883851931330472
1913,TX,M,19341,4791,24132,19.85330681253108
1913,UT,F,1802,263,2065,12.736077481840194
1913,UT,M,1664,340,2004,16.966067864271455
1913,VA,F,13281,2240,15521,14.432059789961988
1913,VA,M,8316,2957,11273,26.230816996362993
1913,VT,F,1162,181,1343,13.47728965003723
1913,VT,M,883,244,1127,21.650399290150844
1913,WA,F,4075,575,4650,12.365591397849462
1913,WA,M,3291,686,3977,17.24918280110636
1913,WI,F,10737,1252,11989,10.442905997164068
1913,WI,M,8342,1599,9941,16.084900915400866
1913,WV,F,7613,1366,8979,15.213275420425438
1913,WV,M,4752,1300,6052,21.480502313284862
1913,WY,F,353,98,451,21.729490022172946
1913,WY,M,316,111,427,25.995316159250585
1914,AK,F,82,33,115,28.695652173913043
1914,AK,M,71,59,130,45.38461538461539
1914,AL,F,17423,2734,20157,13.563526318400557
1914,AL,M,11815,3914,15729,24.883972280500984
1914,AR,F,10874,1514,12388,12.221504681950275
1914,AR,M,7922,2126,10048,21.15843949044586
1914,AZ,F,1218,224,1442,15.53398058252427
1914,AZ,M,1196,335,1531,21.88112344872632
1914,CA,F,12185,1629,13814,11.7923845374258
1914,CA,M,10672,2442,13114,18.621320725941743
1914,CO,F,3714,694,4408,15.744101633393829
1914,CO,M,3247,880,4127,21.322994911558034
1914,CT,F,7967,1658,9625,17.225974025974025
1914,CT,M,5984,2573,8557,30.06894939815356
1914,DC,F,1417,330,1747,18.889524899828277
1914,DC,M,1053,463,1516,30.54089709762533
1914,DE,F,963,211,1174,17.972742759795572
1914,DE,M,610,281,891,31.53759820426487
1914,FL,F,6358,923,7281,12.676830105754705
1914,FL,M,4736,1646,6382,25.79128799749295
1914,GA,F,21767,3268,25035,13.053724785300581
1914,GA,M,15827,5206,21033,24.751580849141824
1914,HI,F,1054,136,1190,11.428571428571429
1914,HI,M,810,249,1059,23.512747875354105
1914,IA,F,11397,1651,13048,12.653280196198653
1914,IA,M,10073,1720,11793,14.584923259560757
1914,ID,F,1802,258,2060,12.524271844660195
1914,ID,M,1694,348,2042,17.042115572967678
1914,IL,F,33493,5615,39108,14.35767617878695
1914,IL,M,27669,7524,35193,21.3792515557071
1914,IN,F,12930,2866,15796,18.14383388199544
1914,IN,M,11653,2830,14483,19.540150521300838
1914,KS,F,7943,1284,9227,13.915682236913407
1914,KS,M,7170,1342,8512,15.765977443609023
1914,KY,F,14648,2615,17263,15.14800440247929
1914,KY,M,10425,2890,13315,21.70484416072099
1914,LA,F,12645,1618,14263,11.344037018859987
1914,LA,M,8466,2524,10990,22.966333030027297
1914,MA,F,23216,4537,27753,16.347782221741795
1914,MA,M,16841,6791,23632,28.73645903859174
1914,MD,F,7609,1609,9218,17.454979388153614
1914,MD,M,5530,2048,7578,27.02560042227501
1914,ME,F,4205,508,4713,10.778697220454063
1914,ME,M,3314,594,3908,15.19959058341863
1914,MI,F,16098,2259,18357,12.30593234188593
1914,MI,M,12478,2908,15386,18.900298973092422
1914,MN,F,11745,1458,13203,11.042944785276074
1914,MN,M,10009,1783,11792,15.120420624151967
1914,MO,F,16633,2595,19228,13.495943415851883
1914,MO,M,13873,3240,17113,18.932974931338748
1914,MS,F,12547,1843,14390,12.807505211952744
1914,MS,M,9702,2943,12645,23.274021352313166
1914,MT,F,2450,361,2811,12.842404838135895
1914,MT,M,2214,521,2735,19.049360146252287
1914,NC,F,20230,3401,23631,14.392112056197368
1914,NC,M,13970,5192,19162,27.09529276693456
1914,ND,F,3848,505,4353,11.601194578451643
1914,ND,M,3219,637,3856,16.519709543568464
1914,NE,F,6426,943,7369,12.796851675939747
1914,NE,M,6138,1024,7162,14.297682211672717
1914,NH,F,2229,345,2574,13.403263403263404
1914,NH,M,1729,432,2161,19.99074502545118
1914,NJ,F,16780,3285,20065,16.37179167704959
1914,NJ,M,12463,5572,18035,30.895481009148877
1914,NM,F,1583,268,1851,14.478660183684495
1914,NM,M,1386,455,1841,24.714828897338403
1914,NV,F,166,34,200,17.0
1914,NV,M,139,66,205,32.19512195121951
1914,NY,F,62987,10331,73318,14.090673504460025
1914,NY,M,45985,17568,63553,27.643069563985968
1914,OH,F,27264,5799,33063,17.53924326286181
1914,OH,M,22219,6038,28257,21.368156562975546
1914,OK,F,11849,1545,13394,11.535015678662088
1914,OK,M,8809,1897,10706,17.71903605454885
1914,OR,F,2962,418,3380,12.366863905325443
1914,OR,M,2672,507,3179,15.948411450141553
1914,PA,F,53001,13024,66025,19.725861416130254
1914,PA,M,38665,17261,55926,30.863998855630655
1914,RI,F,3178,636,3814,16.67540639748296
1914,RI,M,2434,1026,3460,29.653179190751445
1914,SC,F,13002,2198,15200,14.460526315789474
1914,SC,M,9266,3743,13009,28.772388346529326
1914,SD,F,3125,394,3519,11.196362603012219
1914,SD,M,2899,462,3361,13.745908955667957
1914,TN,F,14196,2493,16689,14.93798310264246
1914,TN,M,9960,3410,13370,25.50486163051608
1914,TX,F,31565,3796,35361,10.73499052628602
1914,TX,M,23534,5651,29185,19.362686311461367
1914,UT,F,2276,390,2666,14.628657164291074
1914,UT,M,2229,507,2736,18.530701754385966
1914,VA,F,15640,2647,18287,14.474763493191887
1914,VA,M,10309,3641,13950,26.100358422939067
1914,VT,F,1665,268,1933,13.864459389549921
1914,VT,M,1250,268,1518,17.654808959156785
1914,WA,F,4950,666,5616,11.858974358974358
1914,WA,M,4263,942,5205,18.097982708933717
1914,WI,F,12847,1562,14409,10.84044694288292
1914,WI,M,11181,2055,13236,15.525838621940164
1914,WV,F,9038,1719,10757,15.98029190294692
1914,WV,M,6342,1704,8046,21.17822520507084
1914,WY,F,484,114,598,19.063545150501675
1914,WY,M,432,126,558,22.58064516129032
1915,AK,F,98,53,151,35.099337748344375
1915,AK,M,113,61,174,35.05747126436782
1915,AL,F,20157,3118,23275,13.396348012889367
1915,AL,M,14764,4830,19594,24.65040318464836
1915,AR,F,13457,2029,15486,13.10215678677515
1915,AR,M,10362,2661,13023,20.433079935498732
1915,AZ,F,1658,284,1942,14.62409886714727
1915,AZ,M,1606,441,2047,21.543722520762092
1915,CA,F,16466,2176,18642,11.672567321102886
1915,CA,M,13982,3212,17194,18.68093520995696
1915,CO,F,5163,905,6068,14.914304548450891
1915,CO,M,4527,1154,5681,20.31332511881711
1915,CT,F,9614,2079,11693,17.77986829727187
1915,CT,M,7110,3004,10114,29.70140399446312
1915,DC,F,1788,412,2200,18.72727272727273
1915,DC,M,1219,529,1748,30.263157894736842
1915,DE,F,1297,301,1598,18.8360450563204
1915,DE,M,861,399,1260,31.666666666666664
1915,FL,F,7320,1076,8396,12.815626488804194
1915,FL,M,5602,1871,7473,25.036799143583565
1915,GA,F,25245,3774,29019,13.005272407732866
1915,GA,M,18595,6087,24682,24.66169678308079
1915,HI,F,1779,177,1956,9.049079754601227
1915,HI,M,1314,352,1666,21.12845138055222
1915,IA,F,16548,2446,18994,12.877750868695378
1915,IA,M,14572,2342,16914,13.846517677663476
1915,ID,F,2651,428,3079,13.900617083468658
1915,ID,M,2587,444,3031,14.64863081491257
1915,IL,F,45933,7355,53288,13.802357003452936
1915,IL,M,37650,9906,47556,20.83017915720414
1915,IN,F,18655,4193,22848,18.35171568627451
1915,IN,M,16249,3774,20023,18.848324426909056
1915,KS,F,11498,1858,13356,13.911350703803535
1915,KS,M,10573,1945,12518,15.537625818820896
1915,KY,F,19924,3663,23587,15.529740959002842
1915,KY,M,14740,4030,18770,21.470431539690995
1915,LA,F,14951,1874,16825,11.13818722139673
1915,LA,M,10875,3183,14058,22.6419120785318
1915,MA,F,27249,5230,32479,16.102712521937253
1915,MA,M,19954,7769,27723,28.02366266277098
1915,MD,F,9913,2077,11990,17.32276897414512
1915,MD,M,7169,2575,9744,26.426518883415433
1915,ME,F,5156,587,5743,10.221138777642347
1915,ME,M,4087,779,4866,16.009042334566377
1915,MI,F,24348,3473,27821,12.483375867150713
1915,MI,M,19933,4262,24195,17.61520975408142
1915,MN,F,17753,2098,19851,10.568737091330412
1915,MN,M,14774,2553,17327,14.734229814740003
1915,MO,F,22771,3651,26422,13.818030429187797
1915,MO,M,19417,4308,23725,18.158061116965225
1915,MS,F,14419,2172,16591,13.091435115424025
1915,MS,M,11678,3419,15097,22.646883486785455
1915,MT,F,3740,594,4334,13.705583756345177
1915,MT,M,3265,798,4063,19.640659611124782
1915,NC,F,24721,4253,28974,14.678677434941672
1915,NC,M,17486,6209,23695,26.203840472673562
1915,ND,F,5940,729,6669,10.931174089068826
1915,ND,M,4994,921,5915,15.570583262890954
1915,NE,F,9282,1192,10474,11.380561390108841
1915,NE,M,8541,1302,9843,13.227674489484913
1915,NH,F,2723,412,3135,13.141945773524721
1915,NH,M,2087,511,2598,19.66897613548884
1915,NJ,F,22735,4373,27108,16.131769219418622
1915,NJ,M,15892,6970,22862,30.48727145481585
1915,NM,F,2209,380,2589,14.677481653147934
1915,NM,M,2117,605,2722,22.226304188096986
1915,NV,F,166,46,212,21.69811320754717
1915,NV,M,165,80,245,32.6530612244898
1915,NY,F,78492,13059,91551,14.264180620637678
1915,NY,M,57286,21087,78373,26.905949753103748
1915,OH,F,37548,8096,45644,17.737271054245905
1915,OH,M,31225,8120,39345,20.63794637183886
1915,OK,F,14777,2028,16805,12.067836953287712
1915,OK,M,12616,2558,15174,16.857783049953866
1915,OR,F,4100,580,4680,12.393162393162394
1915,OR,M,3574,711,4285,16.59276546091015
1915,PA,F,69876,17368,87244,19.90738618128467
1915,PA,M,50592,21750,72342,30.065522103342456
1915,RI,F,3788,740,4528,16.342756183745582
1915,RI,M,2684,1124,3808,29.516806722689076
1915,SC,F,14879,2600,17479,14.874992848561131
1915,SC,M,10651,4481,15132,29.612741210679356
1915,SD,F,4502,558,5060,11.027667984189723
1915,SD,M,4004,600,4604,13.032145960034752
1915,TN,F,18192,3245,21437,15.137379297476325
1915,TN,M,13188,4422,17610,25.110732538330495
1915,TX,F,38418,4699,43117,10.898253589071597
1915,TX,M,29977,7075,37052,19.094785706574545
1915,UT,F,3449,583,4032,14.459325396825399
1915,UT,M,3088,580,3668,15.812431842966193
1915,VA,F,19777,3217,22994,13.99060624510742
1915,VA,M,13697,4364,18061,24.162560212612814
1915,VT,F,2144,312,2456,12.703583061889251
1915,VT,M,1646,319,1965,16.23409669211196
1915,WA,F,6861,957,7818,12.240982348426707
1915,WA,M,6168,1175,7343,16.00163420945118
1915,WI,F,18844,2341,21185,11.050271418456454
1915,WI,M,16190,2881,19071,15.106706517749464
1915,WV,F,12457,2338,14795,15.802636025684352
1915,WV,M,8788,2344,11132,21.056413941789437
1915,WY,F,771,152,923,16.468039003250272
1915,WY,M,705,218,923,23.61863488624052
1916,AK,F,109,39,148,26.351351351351347
1916,AK,M,115,57,172,33.13953488372093
1916,AL,F,22361,3492,25853,13.507136502533553
1916,AL,M,16111,5088,21199,24.001132128874005
1916,AR,F,14260,2133,16393,13.011651314585492
1916,AR,M,10872,2846,13718,20.746464499198133
1916,AZ,F,2052,313,2365,13.234672304439746
1916,AZ,M,1929,508,2437,20.845301600328273
1916,CA,F,17251,2303,19554,11.777641403293444
1916,CA,M,14609,3351,17960,18.65812917594655
1916,CO,F,5736,1058,6794,15.57256402708272
1916,CO,M,4957,1256,6213,20.215676806695637
1916,CT,F,10920,2155,13075,16.481835564053537
1916,CT,M,8003,3505,11508,30.457073340285017
1916,DC,F,1884,423,2307,18.33550065019506
1916,DC,M,1427,603,2030,29.704433497536947
1916,DE,F,1353,265,1618,16.378244746600743
1916,DE,M,984,449,1433,31.332868108862527
1916,FL,F,7531,1152,8683,13.267303927214098
1916,FL,M,5616,1912,7528,25.398512221041447
1916,GA,F,27118,4226,31344,13.482644206227668
1916,GA,M,19496,6672,26168,25.49678997248548
1916,HI,F,2065,203,2268,8.950617283950617
1916,HI,M,1450,394,1844,21.36659436008677
1916,IA,F,18047,2650,20697,12.803787988597382
1916,IA,M,15519,2540,18059,14.065009136718535
1916,ID,F,3098,500,3598,13.896609227348527
1916,ID,M,2749,487,3236,15.049443757725586
1916,IL,F,49944,7980,57924,13.776672881707064
1916,IL,M,39696,10024,49720,20.1609010458568
1916,IN,F,19147,4562,23709,19.241638196465477
1916,IN,M,16423,3934,20357,19.32504789507295
1916,KS,F,12825,1972,14797,13.327025748462527
1916,KS,M,11209,1984,13193,15.038277874630484
1916,KY,F,20253,3796,24049,15.784440101459522
1916,KY,M,15493,4237,19730,21.474911302584896
1916,LA,F,15791,1942,17733,10.951333671685557
1916,LA,M,11572,3277,14849,22.068826183581386
1916,MA,F,28037,5232,33269,15.72635185908804
1916,MA,M,20909,8150,29059,28.046388382256787
1916,MD,F,9916,2129,12045,17.67538397675384
1916,MD,M,7550,2666,10216,26.09631949882537
1916,ME,F,5046,672,5718,11.752360965372507
1916,ME,M,3992,740,4732,15.638207945900254
1916,MI,F,28342,3927,32269,12.169574514239672
1916,MI,M,22738,4846,27584,17.568155452436194
1916,MN,F,19300,2349,21649,10.850385699108504
1916,MN,M,16164,2663,18827,14.144579593137516
1916,MO,F,24770,4075,28845,14.127231755936903
1916,MO,M,20136,4491,24627,18.236082348641737
1916,MS,F,15687,2319,18006,12.87904031989337
1916,MS,M,12522,3704,16226,22.827560705041293
1916,MT,F,4493,627,5120,12.24609375
1916,MT,M,3897,844,4741,17.80215144484286
1916,NC,F,26068,4466,30534,14.62631820265933
1916,NC,M,18644,6523,25167,25.91886200182779
1916,ND,F,6624,876,7500,11.68
1916,ND,M,5631,1070,6701,15.96776600507387
1916,NE,F,9911,1350,11261,11.98827812805257
1916,NE,M,9020,1395,10415,13.394143062890063
1916,NH,F,2617,368,2985,12.328308207705192
1916,NH,M,2067,516,2583,19.97677119628339
1916,NJ,F,24301,4403,28704,15.339325529542922
1916,NJ,M,16809,7433,24242,30.66166157907763
1916,NM,F,2586,411,2997,13.713713713713712
1916,NM,M,2127,593,2720,21.801470588235293
1916,NV,F,221,55,276,19.92753623188406
1916,NV,M,195,95,290,32.758620689655174
1916,NY,F,80719,13254,93973,14.104051163632105
1916,NY,M,58849,21465,80314,26.726349079861546
1916,OH,F,39806,8177,47983,17.041452180980766
1916,OH,M,32066,8555,40621,21.060535191157285
1916,OK,F,16184,2153,18337,11.74128810601516
1916,OK,M,12962,2612,15574,16.771542314113265
1916,OR,F,4300,562,4862,11.559029206088029
1916,OR,M,3749,686,4435,15.467869222096956
1916,PA,F,72016,17242,89258,19.317036007976878
1916,PA,M,51395,22016,73411,29.990055986160115
1916,RI,F,4155,786,4941,15.907710989678204
1916,RI,M,2997,1119,4116,27.1865889212828
1916,SC,F,16401,2826,19227,14.698080823841472
1916,SC,M,12044,4741,16785,28.24545725350015
1916,SD,F,5168,672,5840,11.506849315068493
1916,SD,M,4379,735,5114,14.372311302307391
1916,TN,F,19563,3542,23105,15.330015148236312
1916,TN,M,14148,4565,18713,24.39480575001336
1916,TX,F,39992,5051,45043,11.21372910330129
1916,TX,M,31000,7310,38310,19.081179848603497
1916,UT,F,3884,573,4457,12.85618128786179
1916,UT,M,3333,624,3957,15.769522365428355
1916,VA,F,20816,3454,24270,14.2315615986815
1916,VA,M,13970,4499,18469,24.359737939249555
1916,VT,F,2053,339,2392,14.172240802675585
1916,VT,M,1713,343,2056,16.682879377431906
1916,WA,F,7415,971,8386,11.578821845933698
1916,WA,M,6285,1187,7472,15.885974304068522
1916,WI,F,20973,2553,23526,10.85182351440959
1916,WI,M,17140,2952,20092,14.692414891499103
1916,WV,F,12787,2401,15188,15.808533052409798
1916,WV,M,8857,2343,11200,20.919642857142858
1916,WY,F,885,211,1096,19.251824817518248
1916,WY,M,795,229,1024,22.36328125
1917,AK,F,81,33,114,28.947368421052634
1917,AK,M,95,67,162,41.358024691358025
1917,AL,F,21385,3486,24871,14.016324233042498
1917,AL,M,15276,5001,20277,24.663411747299897
1917,AR,F,15732,2270,18002,12.609710032218644
1917,AR,M,11785,3068,14853,20.65575977916919
1917,AZ,F,2428,393,2821,13.931230060262317
1917,AZ,M,2104,591,2695,21.929499072356215
1917,CA,F,18449,2417,20866,11.58343717051663
1917,CA,M,15649,3411,19060,17.896117523609654
1917,CO,F,6293,1046,7339,14.252622973157106
1917,CO,M,5421,1311,6732,19.474153297682708
1917,CT,F,12113,2315,14428,16.04518990851123
1917,CT,M,8932,3720,12652,29.402466013278534
1917,DC,F,2113,443,2556,17.33176838810642
1917,DC,M,1505,671,2176,30.83639705882353
1917,DE,F,1483,309,1792,17.243303571428573
1917,DE,M,966,468,1434,32.63598326359833
1917,FL,F,7675,1238,8913,13.889823852799282
1917,FL,M,5806,2015,7821,25.763968801943488
1917,GA,F,26877,4360,31237,13.957806447482152
1917,GA,M,19680,6536,26216,24.931339639914558
1917,HI,F,2447,208,2655,7.834274952919021
1917,HI,M,1668,412,2080,19.807692307692307
1917,IA,F,17900,2731,20631,13.237361252484126
1917,IA,M,15964,2550,18514,13.773360700010803
1917,ID,F,3282,483,3765,12.828685258964143
1917,ID,M,2922,514,3436,14.959254947613504
1917,IL,F,50204,8029,58233,13.787714869575671
1917,IL,M,40058,9999,50057,19.97522823980662
1917,IN,F,19720,4560,24280,18.780889621087315
1917,IN,M,17121,3991,21112,18.90394088669951
1917,KS,F,12954,2009,14963,13.426451914722984
1917,KS,M,11594,2106,13700,15.372262773722628
1917,KY,F,20829,3931,24760,15.876413570274636
1917,KY,M,15434,4482,19916,22.504518979714803
1917,LA,F,16791,1973,18764,10.514815604348753
1917,LA,M,11724,3439,15163,22.68020840203126
1917,MA,F,29704,5472,35176,15.556060950648169
1917,MA,M,22243,8144,30387,26.80093461019515
1917,MD,F,10589,2145,12734,16.844667818438825
1917,MD,M,7953,2648,10601,24.978775587208755
1917,ME,F,5420,635,6055,10.487200660611066
1917,ME,M,4376,851,5227,16.280849435622727
1917,MI,F,29894,4275,34169,12.51134068892856
1917,MI,M,24268,5103,29371,17.37428075312383
1917,MN,F,19322,2259,21581,10.467540892451693
1917,MN,M,16221,2718,18939,14.351338507840964
1917,MO,F,24417,4150,28567,14.527251724017223
1917,MO,M,19966,4509,24475,18.42288049029622
1917,MS,F,15284,2313,17597,13.14428595783372
1917,MS,M,12361,3668,16029,22.88352361345062
1917,MT,F,5194,746,5940,12.558922558922559
1917,MT,M,4386,1015,5401,18.7928161451583
1917,NC,F,26955,4546,31501,14.431287895622361
1917,NC,M,19610,6873,26483,25.952497828795828
1917,ND,F,6951,821,7772,10.563561502830675
1917,ND,M,5639,985,6624,14.870169082125603
1917,NE,F,10449,1358,11807,11.501651562632336
1917,NE,M,9361,1456,10817,13.460293981695479
1917,NH,F,2752,368,3120,11.794871794871794
1917,NH,M,2216,511,2727,18.73854052071874
1917,NJ,F,25351,4524,29875,15.143096234309624
1917,NJ,M,18221,7868,26089,30.15830426616582
1917,NM,F,2766,427,3193,13.373003445036016
1917,NM,M,2368,654,3022,21.641297154202515
1917,NV,F,183,67,250,26.8
1917,NV,M,260,99,359,27.57660167130919
1917,NY,F,83536,13670,97206,14.062917926876942
1917,NY,M,62425,22621,85046,26.598546668861555
1917,OH,F,42032,8662,50694,17.086834733893557
1917,OH,M,34603,9020,43623,20.677165715333654
1917,OK,F,17494,2317,19811,11.69552268941497
1917,OK,M,13823,2820,16643,16.944060566003724
1917,OR,F,4281,593,4874,12.166598276569554
1917,OR,M,3836,711,4547,15.636683527600614
1917,PA,F,75756,17664,93420,18.908156711624923
1917,PA,M,54799,22846,77645,29.423658960654258
1917,RI,F,4351,814,5165,15.759922555663117
1917,RI,M,3169,1225,4394,27.87892580791989
1917,SC,F,16700,2849,19549,14.573635480075708
1917,SC,M,12102,4800,16902,28.399006034788783
1917,SD,F,5461,670,6131,10.928070461588648
1917,SD,M,4633,727,5360,13.563432835820896
1917,TN,F,20763,3616,24379,14.832437753804504
1917,TN,M,14983,4880,19863,24.568292805719178
1917,TX,F,41871,5394,47265,11.412250079339891
1917,TX,M,32108,7552,39660,19.04185577407968
1917,UT,F,3997,644,4641,13.8763197586727
1917,UT,M,3391,647,4038,16.02278355621595
1917,VA,F,21438,3620,25058,14.446484156756325
1917,VA,M,14902,4844,19746,24.531550693811404
1917,VT,F,2208,326,2534,12.86503551696922
1917,VT,M,1685,315,2000,15.75
1917,WA,F,7620,1075,8695,12.363427257044277
1917,WA,M,6403,1247,7650,16.30065359477124
1917,WI,F,20710,2582,23292,11.085351193542847
1917,WI,M,17698,3151,20849,15.113434697107774
1917,WV,F,13574,2542,16116,15.773144700918342
1917,WV,M,9480,2573,12053,21.347382394424624
1917,WY,F,1068,204,1272,16.037735849056602
1917,WY,M,939,270,1209,22.332506203473944
1918,AK,F,88,67,155,43.225806451612904
1918,AK,M,109,78,187,41.711229946524064
1918,AL,F,23127,3637,26764,13.5891496039456
1918,AL,M,17168,5810,22978,25.28505527025851
1918,AR,F,17013,2489,19502,12.762793559634908
1918,AR,M,12812,3419,16231,21.06462941285195
1918,AZ,F,2719,474,3193,14.844973379267145
1918,AZ,M,2508,682,3190,21.379310344827587
1918,CA,F,20406,2647,23053,11.482236585260052
1918,CA,M,17837,3811,21648,17.60439763488544
1918,CO,F,7031,1192,8223,14.495926061048278
1918,CO,M,6113,1354,7467,18.133119057184945
1918,CT,F,12388,2300,14688,15.659041394335512
1918,CT,M,9356,3735,13091,28.53105186769536
1918,DC,F,2472,492,2964,16.599190283400812
1918,DC,M,1933,760,2693,28.221314519123652
1918,DE,F,1724,373,2097,17.787315212207915
1918,DE,M,1100,508,1608,31.592039800995025
1918,FL,F,8559,1209,9768,12.377149877149877
1918,FL,M,6629,2179,8808,24.738873751135333
1918,GA,F,29568,4755,34323,13.853684118521109
1918,GA,M,22028,7243,29271,24.744627788596222
1918,HI,F,2454,244,2698,9.04373610081542
1918,HI,M,1725,448,2173,20.616658996778646
1918,IA,F,19230,2774,22004,12.606798763861116
1918,IA,M,17446,2771,20217,13.706286788346441
1918,ID,F,3663,582,4245,13.710247349823321
1918,ID,M,3432,549,3981,13.790504898266768
1918,IL,F,53830,8160,61990,13.16341345378287
1918,IL,M,43717,10914,54631,19.977668356793764
1918,IN,F,21157,4801,25958,18.495261576392636
1918,IN,M,19017,4376,23393,18.706450647629634
1918,KS,F,13837,2108,15945,13.220445280652243
1918,KS,M,12613,2124,14737,14.412702721042276
1918,KY,F,22606,4423,27029,16.363905434903252
1918,KY,M,18164,4931,23095,21.35094176228621
1918,LA,F,18377,2336,20713,11.277941389465553
1918,LA,M,13376,3858,17234,22.38598119995358
1918,MA,F,31162,5772,36934,15.6278767531272
1918,MA,M,23746,8832,32578,27.110319847750013
1918,MD,F,11322,2425,13747,17.64021240998036
1918,MD,M,8827,2944,11771,25.010619318664514
1918,ME,F,5722,718,6440,11.149068322981366
1918,ME,M,4674,942,5616,16.773504273504273
1918,MI,F,32295,4355,36650,11.882673942701228
1918,MI,M,27255,5527,32782,16.859862119455798
1918,MN,F,20270,2249,22519,9.987121985878591
1918,MN,M,17445,2967,20412,14.53556731334509
1918,MO,F,26319,4416,30735,14.36798438262567
1918,MO,M,21923,4860,26783,18.145838778329537
1918,MS,F,16816,2476,19292,12.83433547584491
1918,MS,M,13709,4095,17804,23.00044933722759
1918,MT,F,5589,833,6422,12.971037060105886
1918,MT,M,4485,1115,5600,19.910714285714285
1918,NC,F,29058,4856,33914,14.31857050185764
1918,NC,M,21679,7664,29343,26.11866543979825
1918,ND,F,6834,795,7629,10.420762878489972
1918,ND,M,5764,1037,6801,15.247757682693722
1918,NE,F,11169,1397,12566,11.117300652554512
1918,NE,M,9897,1451,11348,12.786394078251675
1918,NH,F,2965,419,3384,12.381796690307329
1918,NH,M,2422,574,2996,19.158878504672895
1918,NJ,F,26942,4700,31642,14.853675494595791
1918,NJ,M,19511,7954,27465,28.960495175678137
1918,NM,F,3202,530,3732,14.201500535905682
1918,NM,M,2662,712,3374,21.10254890337878
1918,NV,F,222,44,266,16.541353383458645
1918,NV,M,242,89,331,26.888217522658607
1918,NY,F,87387,13777,101164,13.61848088252738
1918,NY,M,66434,23399,89833,26.047220954437677
1918,OH,F,45255,9260,54515,16.986150600752087
1918,OH,M,38138,9889,48027,20.590501176421597
1918,OK,F,20693,2648,23341,11.344843837024978
1918,OK,M,16234,3422,19656,17.40944240944241
1918,OR,F,4738,646,5384,11.99851411589896
1918,OR,M,4255,787,5042,15.608885362951211
1918,PA,F,81245,18322,99567,18.40167927124449
1918,PA,M,61148,25305,86453,29.270239320787017
1918,RI,F,4796,789,5585,14.12712623097583
1918,RI,M,3525,1265,4790,26.40918580375783
1918,SC,F,18576,3168,21744,14.56953642384106
1918,SC,M,13730,5634,19364,29.09522825862425
1918,SD,F,5746,711,6457,11.011305559857519
1918,SD,M,5133,681,5814,11.71310629514964
1918,TN,F,21734,3978,25712,15.471375233354076
1918,TN,M,16534,5390,21924,24.584929757343552
1918,TX,F,44028,5498,49526,11.101239752857085
1918,TX,M,34160,8362,42522,19.66511452894972
1918,UT,F,4601,652,5253,12.411955073291454
1918,UT,M,4021,681,4702,14.483198638877074
1918,VA,F,23287,3853,27140,14.196757553426675
1918,VA,M,16587,5458,22045,24.758448627806757
1918,VT,F,2293,333,2626,12.680883472962682
1918,VT,M,1943,399,2342,17.03672075149445
1918,WA,F,8760,1148,9908,11.586596689543804
1918,WA,M,7562,1431,8993,15.912376292672079
1918,WI,F,22228,2757,24985,11.034620772463478
1918,WI,M,18942,3304,22246,14.85210824417873
1918,WV,F,14909,2657,17566,15.125811226232495
1918,WV,M,11165,2865,14030,20.420527441197432
1918,WY,F,1346,238,1584,15.025252525252524
1918,WY,M,1082,279,1361,20.49963262307127
1919,AK,F,167,41,208,19.71153846153846
1919,AK,M,133,73,206,35.43689320388349
1919,AL,F,26556,4265,30821,13.837967619480224
1919,AL,M,19165,6343,25508,24.866708483612985
1919,AR,F,17832,2460,20292,12.12300413956239
1919,AR,M,13593,3623,17216,21.044377323420075
1919,AZ,F,2790,445,3235,13.75579598145286
1919,AZ,M,2597,669,3266,20.483772198407838
1919,CA,F,20716,2573,23289,11.048134312336295
1919,CA,M,18036,3793,21829,17.375967749324293
1919,CO,F,6687,1046,7733,13.526445105392474
1919,CO,M,5796,1366,7162,19.072884669086847
1919,CT,F,11498,2037,13535,15.049870705578131
1919,CT,M,8620,3361,11981,28.052750187797347
1919,DC,F,2461,511,2972,17.19380888290713
1919,DC,M,1911,753,2664,28.265765765765767
1919,DE,F,1686,389,2075,18.746987951807228
1919,DE,M,1139,472,1611,29.298572315332095
1919,FL,F,8768,1341,10109,13.265407063013157
1919,FL,M,6731,2264,8995,25.16953863257365
1919,GA,F,32137,5010,37147,13.486957224001939
1919,GA,M,23315,7746,31061,24.938025176266056
1919,HI,F,2611,239,2850,8.385964912280702
1919,HI,M,1731,424,2155,19.67517401392111
1919,IA,F,17932,2604,20536,12.680171406310869
1919,IA,M,16125,2450,18575,13.189771197846568
1919,ID,F,3561,574,4135,13.881499395405077
1919,ID,M,3060,530,3590,14.763231197771587
1919,IL,F,49293,7660,56953,13.449686583674259
1919,IL,M,39788,9540,49328,19.339928640934158
1919,IN,F,19683,4569,24252,18.83968332508659
1919,IN,M,17180,4112,21292,19.31241780950592
1919,KS,F,13431,2029,15460,13.124191461836999
1919,KS,M,11935,2062,13997,14.731728227477317
1919,KY,F,22700,4330,27030,16.01923788383278
1919,KY,M,17954,4870,22824,21.337188923939713
1919,LA,F,19261,2480,21741,11.407018996366313
1919,LA,M,13900,4001,17901,22.350706664432156
1919,MA,F,29469,5279,34748,15.192241280073674
1919,MA,M,22183,8125,30308,26.808103471030755
1919,MD,F,11532,2417,13949,17.327406982579397
1919,MD,M,8833,3028,11861,25.52904476856926
1919,ME,F,5268,702,5970,11.758793969849247
1919,ME,M,4479,821,5300,15.490566037735848
1919,MI,F,29962,3909,33871,11.540846151575094
1919,MI,M,24134,4946,29080,17.008253094910593
1919,MN,F,19182,2186,21368,10.23025084238113
1919,MN,M,16574,2607,19181,13.59157499608988
1919,MO,F,24988,3973,28961,13.71844894858603
1919,MO,M,20832,4544,25376,17.90668348045397
1919,MS,F,19061,2814,21875,12.864
1919,MS,M,15074,4537,19611,23.134975268981695
1919,MT,F,4738,678,5416,12.518463810930577
1919,MT,M,3904,945,4849,19.488554341101256
1919,NC,F,30760,5265,36025,14.614850798056905
1919,NC,M,22592,8096,30688,26.38164754953076
1919,ND,F,6367,744,7111,10.462663479116861
1919,ND,M,5349,976,6325,15.430830039525691
1919,NE,F,10334,1322,11656,11.341798215511325
1919,NE,M,9419,1346,10765,12.503483511379471
1919,NH,F,2749,422,3171,13.308104698833176
1919,NH,M,2251,529,2780,19.028776978417266
1919,NJ,F,26072,4547,30619,14.85025637675953
1919,NJ,M,19017,7722,26739,28.879165264220802
1919,NM,F,2789,456,3245,14.052388289676426
1919,NM,M,2498,685,3183,21.5205780710022
1919,NV,F,187,49,236,20.76271186440678
1919,NV,M,234,74,308,24.025974025974026
1919,NY,F,82654,12812,95466,13.42048477992165
1919,NY,M,62426,21760,84186,25.84752809255696
1919,OH,F,41768,8523,50291,16.94736632797121
1919,OH,M,34965,8672,43637,19.87304351811536
1919,OK,F,19624,2581,22205,11.623508218869624
1919,OK,M,15570,3225,18795,17.158818834796488
1919,OR,F,4648,642,5290,12.136105860113421
1919,OR,M,4294,746,5040,14.801587301587302
1919,PA,F,76317,16864,93181,18.09811012974748
1919,PA,M,56331,22936,79267,28.935118018847696
1919,RI,F,4462,756,5218,14.488309697201993
1919,RI,M,3375,1206,4581,26.326129666011788
1919,SC,F,20151,3505,23656,14.816537030774434
1919,SC,M,14423,5868,20291,28.91922527228821
1919,SD,F,5537,685,6222,11.009321761491481
1919,SD,M,4993,721,5714,12.618130906545327
1919,TN,F,21867,4014,25881,15.509447084733974
1919,TN,M,16420,5504,21924,25.104907863528553
1919,TX,F,46094,5766,51860,11.11839568067875
1919,TX,M,36535,8661,45196,19.163200283210905
1919,UT,F,4097,608,4705,12.922422954303933
1919,UT,M,3564,605,4169,14.511873350923482
1919,VA,F,23367,4066,27433,14.821565268107753
1919,VA,M,16416,5402,21818,24.759372994774957
1919,VT,F,2124,329,2453,13.412148389726866
1919,VT,M,1785,337,2122,15.881244109330819
1919,WA,F,8545,1123,9668,11.615639222176252
1919,WA,M,7638,1307,8945,14.61151481274455
1919,WI,F,20355,2455,22810,10.762823323103902
1919,WI,M,17354,2991,20345,14.70140083558614
1919,WV,F,14201,2584,16785,15.394697646708371
1919,WV,M,10603,2781,13384,20.77854154213987
1919,WY,F,1180,227,1407,16.13361762615494
1919,WY,M,1097,298,1395,21.36200716845878
1920,AK,F,159,70,229,30.567685589519648
1920,AK,M,121,84,205,40.97560975609756
1920,AL,F,26365,4373,30738,14.2266900904418
1920,AL,M,19237,6409,25646,24.99025189113312
1920,AR,F,18104,2679,20783,12.890343068854351
1920,AR,M,13668,3850,17518,21.977394679757964
1920,AZ,F,3231,511,3742,13.655799037947622
1920,AZ,M,2936,714,3650,19.561643835616437
1920,CA,F,24904,3232,28136,11.48706283764572
1920,CA,M,21475,4542,26017,17.457816043356267
1920,CO,F,7672,1237,8909,13.884835559546527
1920,CO,M,6669,1522,8191,18.581369796117688
1920,CT,F,11745,2037,13782,14.78014801915542
1920,CT,M,9033,3424,12457,27.486553744882396
1920,DC,F,2790,510,3300,15.454545454545453
1920,DC,M,2126,856,2982,28.70556673373575
1920,DE,F,1653,334,1987,16.80926019124308
1920,DE,M,1234,523,1757,29.766647694934544
1920,FL,F,9179,1354,10533,12.85483717839172
1920,FL,M,7183,2498,9681,25.803119512447058
1920,GA,F,32115,5258,37373,14.068980279881197
1920,GA,M,23945,8135,32080,25.35847880299252
1920,HI,F,2734,243,2977,8.162579778300302
1920,HI,M,1810,426,2236,19.051878354203936
1920,IA,F,19360,2893,22253,13.00049431537321
1920,IA,M,18188,2730,20918,13.050960894923033
1920,ID,F,3789,566,4355,12.996555683122848
1920,ID,M,3398,621,4019,15.451604876835034
1920,IL,F,51201,7977,59178,13.47967149954375
1920,IL,M,43370,10032,53402,18.78581326542077
1920,IN,F,21621,4852,26473,18.328107883503947
1920,IN,M,19440,4463,23903,18.67129648998034
1920,KS,F,14431,2115,16546,12.782545630363835
1920,KS,M,13593,2280,15873,14.364014364014363
1920,KY,F,24280,4642,28922,16.050065693935412
1920,KY,M,19368,5566,24934,22.322932541910646
1920,LA,F,20099,2568,22667,11.329245158159438
1920,LA,M,14458,4231,18689,22.638985499491678
1920,MA,F,30616,5618,36234,15.504774521167963
1920,MA,M,24378,8892,33270,26.72678088367899
1920,MD,F,12367,2549,14916,17.08903191204076
1920,MD,M,9644,3296,12940,25.471406491499227
1920,ME,F,5969,790,6759,11.688119544311288
1920,ME,M,5006,886,5892,15.037338764426341
1920,MI,F,33400,4353,37753,11.530209519773264
1920,MI,M,28113,5638,33751,16.70469023140055
1920,MN,F,20557,2344,22901,10.235360901270688
1920,MN,M,18214,2883,21097,13.66545006399014
1920,MO,F,26325,4337,30662,14.144543734916182
1920,MO,M,22879,4995,27874,17.919925378488916
1920,MS,F,18619,2787,21406,13.019714098850791
1920,MS,M,14811,4482,19293,23.231223759912922
1920,MT,F,4368,675,5043,13.38488994646044
1920,MT,M,3890,908,4798,18.924551896623594
1920,NC,F,31663,5673,37336,15.194450396400258
1920,NC,M,24335,8558,32893,26.01769373422917
1920,ND,F,6728,798,7526,10.603242094073877
1920,ND,M,5623,1027,6650,15.44360902255639
1920,NE,F,11264,1400,12664,11.054958938723942
1920,NE,M,10472,1472,11944,12.324179504353651
1920,NH,F,3189,410,3599,11.392053348152265
1920,NH,M,2539,566,3105,18.22866344605475
1920,NJ,F,27127,4507,31634,14.24732882341784
1920,NJ,M,20799,8294,29093,28.508575946103875
1920,NM,F,3278,521,3799,13.714135298762834
1920,NM,M,2875,800,3675,21.768707482993197
1920,NV,F,243,45,288,15.625
1920,NV,M,242,66,308,21.428571428571427
1920,NY,F,85645,13121,98766,13.284936111617357
1920,NY,M,67766,22679,90445,25.07490740228868
1920,OH,F,46028,9279,55307,16.777261467806966
1920,OH,M,39388,9900,49288,20.086024995942218
1920,OK,F,22455,3042,25497,11.930815390045888
1920,OK,M,18084,3672,21756,16.878102592388306
1920,OR,F,5328,643,5971,10.768715458047229
1920,OR,M,4800,822,5622,14.621131270010673
1920,PA,F,80144,17330,97474,17.779100067710363
1920,PA,M,60861,24032,84893,28.30857667887812
1920,RI,F,4761,847,5608,15.10342368045649
1920,RI,M,3733,1339,5072,26.399842271293377
1920,SC,F,21134,3597,24731,14.544498807165096
1920,SC,M,14968,6272,21240,29.529190207156308
1920,SD,F,6094,688,6782,10.14450014744913
1920,SD,M,5515,733,6248,11.731754161331626
1920,TN,F,23705,4177,27882,14.98099132056524
1920,TN,M,17656,5886,23542,25.0021238637329
1920,TX,F,50504,6504,57008,11.408925063149033
1920,TX,M,41055,9784,50839,19.2450677629379
1920,UT,F,4440,655,5095,12.855740922473014
1920,UT,M,3970,711,4681,15.189062166203804
1920,VA,F,24544,4202,28746,14.617685938913242
1920,VA,M,18101,5874,23975,24.500521376433785
1920,VT,F,2279,317,2596,12.211093990755009
1920,VT,M,1950,376,2326,16.165090283748924
1920,WA,F,9239,1265,10504,12.043031226199544
1920,WA,M,8268,1498,9766,15.338930985050176
1920,WI,F,21707,2706,24413,11.084258386924999
1920,WI,M,19472,3206,22678,14.137049122497574
1920,WV,F,15717,2777,18494,15.015680761328
1920,WV,M,11994,3224,15218,21.185438296753844
1920,WY,F,1349,248,1597,15.529117094552285
1920,WY,M,1305,304,1609,18.89372280919826
1921,AK,F,129,47,176,26.704545454545453
1921,AK,M,145,84,229,36.681222707423586
1921,AL,F,26318,4400,30718,14.323849208932874
1921,AL,M,19484,6636,26120,25.405819295558956
1921,AR,F,18271,2665,20936,12.72927015666794
1921,AR,M,14060,3825,17885,21.38663684651943
1921,AZ,F,3084,440,3524,12.485811577752553
1921,AZ,M,2744,662,3406,19.436288901937758
1921,CA,F,27084,3391,30475,11.127153404429862
1921,CA,M,23521,4990,28511,17.502016765458947
1921,CO,F,8028,1311,9339,14.037905557340185
1921,CO,M,7209,1587,8796,18.042291950886767
1921,CT,F,11799,2021,13820,14.623733719247467
1921,CT,M,9249,3561,12810,27.798594847775178
1921,DC,F,2721,608,3329,18.263742865725444
1921,DC,M,2225,874,3099,28.202646014843495
1921,DE,F,1578,324,1902,17.034700315457414
1921,DE,M,1149,511,1660,30.783132530120483
1921,FL,F,9817,1510,11327,13.330979076542773
1921,FL,M,7578,2508,10086,24.866151100535397
1921,GA,F,31320,5212,36532,14.266944049052885
1921,GA,M,23273,7966,31239,25.500176061973818
1921,HI,F,2762,242,3004,8.055925432756325
1921,HI,M,2092,454,2546,17.831893165750195
1921,IA,F,19915,2914,22829,12.764466249069168
1921,IA,M,18833,2979,21812,13.657619658903355
1921,ID,F,3949,570,4519,12.613410046470458
1921,ID,M,3564,609,4173,14.593817397555714
1921,IL,F,53131,7972,61103,13.046822578269479
1921,IL,M,45432,10745,56177,19.127044876016875
1921,IN,F,22451,5158,27609,18.682313738273752
1921,IN,M,21034,4669,25703,18.165194724351245
1921,KS,F,15303,2260,17563,12.867961054489552
1921,KS,M,14013,2362,16375,14.42442748091603
1921,KY,F,26497,5070,31567,16.06107644058669
1921,KY,M,20530,5824,26354,22.099112089246415
1921,LA,F,20831,2612,23443,11.141918696412576
1921,LA,M,14837,4172,19009,21.947498553316848
1921,MA,F,31328,5641,36969,15.258730287538208
1921,MA,M,25099,9078,34177,26.561722796032424
1921,MD,F,12507,2638,15145,17.418289864641796
1921,MD,M,10152,3282,13434,24.43054935238946
1921,ME,F,6047,711,6758,10.520864160994376
1921,ME,M,5292,958,6250,15.328
1921,MI,F,34829,4505,39334,11.453195708547312
1921,MI,M,29747,5744,35491,16.184384773604577
1921,MN,F,21377,2416,23793,10.15424704745093
1921,MN,M,19028,3040,22068,13.775602682617363
1921,MO,F,27698,4571,32269,14.165297963990206
1921,MO,M,23983,5393,29376,18.35852396514161
1921,MS,F,18696,2815,21511,13.086327925247549
1921,MS,M,14283,4357,18640,23.374463519313306
1921,MT,F,4300,669,4969,13.46347353592272
1921,MT,M,3762,861,4623,18.624269954574952
1921,NC,F,33015,5925,38940,15.215716486902927
1921,NC,M,24859,8473,33332,25.42001680067203
1921,ND,F,6545,756,7301,10.354745925215724
1921,ND,M,5637,1022,6659,15.347649797266858
1921,NE,F,11458,1543,13001,11.868317821706023
1921,NE,M,10745,1588,12333,12.876023676315576
1921,NH,F,3167,436,3603,12.101026922009437
1921,NH,M,2795,584,3379,17.283219887540692
1921,NJ,F,27289,4507,31796,14.174738960875583
1921,NJ,M,21444,8282,29726,27.861131669245776
1921,NM,F,3630,655,4285,15.28588098016336
1921,NM,M,3003,816,3819,21.366849960722703
1921,NV,F,216,64,280,22.857142857142858
1921,NV,M,226,88,314,28.02547770700637
1921,NY,F,87930,12988,100918,12.869854733546045
1921,NY,M,69364,23182,92546,25.049164739697016
1921,OH,F,47423,9513,56936,16.70823380637909
1921,OH,M,41733,10412,52145,19.967398600057532
1921,OK,F,23140,3167,26307,12.038620899380394
1921,OK,M,18981,4010,22991,17.441607585576964
1921,OR,F,5447,720,6167,11.675044592184207
1921,OR,M,5067,943,6010,15.690515806988353
1921,PA,F,83178,17315,100493,17.230055824783815
1921,PA,M,64201,24914,89115,27.957134040285027
1921,RI,F,4879,872,5751,15.162580420796385
1921,RI,M,4030,1367,5397,25.32888641838058
1921,SC,F,20626,3666,24292,15.091388111312366
1921,SC,M,14257,6050,20307,29.792682326291427
1921,SD,F,6089,730,6819,10.705382020824167
1921,SD,M,5645,762,6407,11.893241766817543
1921,TN,F,23948,4481,28429,15.762073938583839
1921,TN,M,18709,6041,24750,24.408080808080808
1921,TX,F,52170,6706,58876,11.390040084244854
1921,TX,M,42569,9805,52374,18.721121166991257
1921,UT,F,4464,661,5125,12.897560975609757
1921,UT,M,4307,713,5020,14.203187250996017
1921,VA,F,25394,4321,29715,14.541477368332492
1921,VA,M,18702,5926,24628,24.062043202858536
1921,VT,F,2445,372,2817,13.205537806176784
1921,VT,M,2111,387,2498,15.492393915132105
1921,WA,F,9349,1187,10536,11.266135155656794
1921,WA,M,8528,1579,10107,15.622835658454537
1921,WI,F,23205,2783,25988,10.708788671694629
1921,WI,M,20592,3457,24049,14.374818079753837
1921,WV,F,17151,3189,20340,15.678466076696166
1921,WV,M,13362,3477,16839,20.64849456618564
1921,WY,F,1542,299,1841,16.24117327539381
1921,WY,M,1348,326,1674,19.47431302270012
1922,AK,F,105,59,164,35.97560975609756
1922,AK,M,171,83,254,32.677165354330704
1922,AL,F,26899,4437,31336,14.159433239724278
1922,AL,M,20004,6770,26774,25.285724957047883
1922,AR,F,18026,2654,20680,12.833655705996131
1922,AR,M,13915,3801,17716,21.4551817566042
1922,AZ,F,2700,451,3151,14.312916534433512
1922,AZ,M,2576,676,3252,20.78720787207872
1922,CA,F,27598,3317,30915,10.729419375707586
1922,CA,M,24893,5214,30107,17.318231640482278
1922,CO,F,7938,1219,9157,13.312220159440866
1922,CO,M,7110,1628,8738,18.631265735866332
1922,CT,F,11049,1779,12828,13.868101028999064
1922,CT,M,8773,3228,12001,26.897758520123322
1922,DC,F,2861,607,3468,17.502883506343714
1922,DC,M,2254,927,3181,29.141779314680917
1922,DE,F,1524,318,1842,17.263843648208468
1922,DE,M,1202,439,1641,26.75198049969531
1922,FL,F,10131,1520,11651,13.046090464337826
1922,FL,M,7989,2447,10436,23.447681103871215
1922,GA,F,32041,5329,37370,14.260101685844258
1922,GA,M,23156,7643,30799,24.815740770804247
1922,HI,F,3150,248,3398,7.298410829899941
1922,HI,M,2261,491,2752,17.84156976744186
1922,IA,F,19191,2695,21886,12.313807913734808
1922,IA,M,18099,2846,20945,13.587968488899499
1922,ID,F,3414,515,3929,13.10766098243828
1922,ID,M,3178,594,3772,15.747613997879109
1922,IL,F,50668,7730,58398,13.236754683379568
1922,IL,M,44818,10693,55511,19.262848804741402
1922,IN,F,21566,4766,26332,18.099650615221023
1922,IN,M,20152,4658,24810,18.774687625957277
1922,KS,F,14221,2097,16318,12.850839563672018
1922,KS,M,13512,2244,15756,14.242193450114243
1922,KY,F,25163,4878,30041,16.237808328617557
1922,KY,M,20261,5700,25961,21.956010939486152
1922,LA,F,21151,2535,23686,10.702524698133917
1922,LA,M,15325,4422,19747,22.39327492783714
1922,MA,F,30120,5314,35434,14.996895636958854
1922,MA,M,24513,8740,33253,26.283342856283642
1922,MD,F,11818,2464,14282,17.252485646268028
1922,MD,M,9521,3101,12622,24.568214229123754
1922,ME,F,6079,771,6850,11.255474452554745
1922,ME,M,5250,955,6205,15.390813859790493
1922,MI,F,32855,4149,37004,11.212301372824559
1922,MI,M,28974,5698,34672,16.434010152284266
1922,MN,F,20909,2266,23175,9.777777777777779
1922,MN,M,19216,3235,22451,14.409157721259632
1922,MO,F,26183,4397,30580,14.378678875081752
1922,MO,M,23134,5043,28177,17.897576037193456
1922,MS,F,19529,3061,22590,13.550243470562195
1922,MS,M,14823,4465,19288,23.14910825383658
1922,MT,F,3930,602,4532,13.28331862312445
1922,MT,M,3646,797,4443,17.938329957236103
1922,NC,F,32804,5819,38623,15.06615229267535
1922,NC,M,25266,8763,34029,25.75156484175262
1922,ND,F,6097,721,6818,10.574948665297741
1922,ND,M,5373,894,6267,14.265198659645764
1922,NE,F,11048,1336,12384,10.78811369509044
1922,NE,M,10501,1539,12040,12.782392026578075
1922,NH,F,3043,416,3459,12.026597282451576
1922,NH,M,2658,588,3246,18.11460258780037
1922,NJ,F,26665,4282,30947,13.836559278766924
1922,NJ,M,20960,8019,28979,27.671762310638737
1922,NM,F,3654,607,4261,14.24548228115466
1922,NM,M,3182,860,4042,21.27659574468085
1922,NV,F,190,41,231,17.74891774891775
1922,NV,M,206,60,266,22.55639097744361
1922,NY,F,86269,12563,98832,12.711469969240733
1922,NY,M,69643,23287,92930,25.058646292908644
1922,OH,F,45575,8975,54550,16.452795600366635
1922,OH,M,39758,10249,50007,20.495130681704563
1922,OK,F,22004,3036,25040,12.124600638977636
1922,OK,M,18403,3735,22138,16.871442768091065
1922,OR,F,5238,620,5858,10.583817002389894
1922,OR,M,4823,906,5729,15.814278233548611
1922,PA,F,79291,16071,95362,16.85262473521948
1922,PA,M,62455,24577,87032,28.239038514569355
1922,RI,F,4885,851,5736,14.836122733612273
1922,RI,M,3833,1367,5200,26.28846153846154
1922,SC,F,21123,3681,24804,14.840348330914368
1922,SC,M,14821,6093,20914,29.13359472123936
1922,SD,F,5817,696,6513,10.686319668355598
1922,SD,M,5402,812,6214,13.067267460572902
1922,TN,F,23780,4415,28195,15.658804752615712
1922,TN,M,18509,6120,24629,24.84875553209631
1922,TX,F,52308,6640,58948,11.264165026803283
1922,TX,M,42624,9780,52404,18.662697504007326
1922,UT,F,4357,611,4968,12.298711755233494
1922,UT,M,4005,609,4614,13.198959687906372
1922,VA,F,24733,4116,28849,14.267392283961316
1922,VA,M,18365,5755,24120,23.859867330016584
1922,VT,F,2363,319,2682,11.894108873974647
1922,VT,M,2077,347,2424,14.315181518151816
1922,WA,F,8707,1134,9841,11.523219185042171
1922,WA,M,8155,1525,9680,15.754132231404958
1922,WI,F,21861,2749,24610,11.170255993498577
1922,WI,M,19955,3378,23333,14.477349676423948
1922,WV,F,16650,3182,19832,16.044776119402986
1922,WV,M,13229,3433,16662,20.603769055335494
1922,WY,F,1439,249,1688,14.751184834123224
1922,WY,M,1352,369,1721,21.441022661243466
1923,AK,F,150,59,209,28.22966507177033
1923,AK,M,151,97,248,39.11290322580645
1923,AL,F,26661,4524,31185,14.506974506974506
1923,AL,M,19116,6462,25578,25.26389866291344
1923,AR,F,17684,2751,20435,13.462197210667973
1923,AR,M,13987,3717,17704,20.99525530953457
1923,AZ,F,2888,465,3353,13.868177751267522
1923,AZ,M,2730,700,3430,20.408163265306122
1923,CA,F,30441,3675,34116,10.77207175518818
1923,CA,M,27884,5915,33799,17.500517766797834
1923,CO,F,7781,1211,8992,13.467526690391459
1923,CO,M,7064,1611,8675,18.570605187319885
1923,CT,F,10916,1773,12689,13.972732287808338
1923,CT,M,8726,3198,11924,26.819859107681985
1923,DC,F,2871,594,3465,17.142857142857142
1923,DC,M,2322,883,3205,27.550702028081126
1923,DE,F,1472,287,1759,16.316088686753837
1923,DE,M,1096,417,1513,27.56113681427627
1923,FL,F,10225,1606,11831,13.574507649395656
1923,FL,M,7782,2447,10229,23.922182031479128
1923,GA,F,29562,4865,34427,14.131350393586429
1923,GA,M,21332,6957,28289,24.592597829545053
1923,HI,F,3162,252,3414,7.381370826010544
1923,HI,M,2272,560,2832,19.774011299435028
1923,IA,F,18625,2752,21377,12.87364924919306
1923,IA,M,17998,2863,20861,13.724174296534203
1923,ID,F,3355,476,3831,12.424954320020882
1923,ID,M,3050,507,3557,14.253584481304472
1923,IL,F,51511,7779,59290,13.120256367009613
1923,IL,M,46258,10950,57208,19.140679625227243
1923,IN,F,22215,4743,26958,17.594035165813487
1923,IN,M,21093,4795,25888,18.522095179233624
1923,KS,F,14484,2133,16617,12.836252031052537
1923,KS,M,13983,2299,16282,14.119886991770054
1923,KY,F,25262,4854,30116,16.117678310532607
1923,KY,M,20126,5735,25861,22.17624995166467
1923,LA,F,20384,2617,23001,11.377766184078954
1923,LA,M,14733,4339,19072,22.75062919463087
1923,MA,F,31217,5242,36459,14.377794234619708
1923,MA,M,25508,8963,34471,26.001566534188157
1923,MD,F,12051,2434,14485,16.803589920607525
1923,MD,M,9552,3300,12852,25.67693744164332
1923,ME,F,5991,681,6672,10.206834532374101
1923,ME,M,5226,977,6203,15.75044333387071
1923,MI,F,34099,4309,38408,11.219016871485108
1923,MI,M,30006,6079,36085,16.846335042261327
1923,MN,F,20610,2294,22904,10.015717778553965
1923,MN,M,19010,3226,22236,14.508005036877137
1923,MO,F,26616,4459,31075,14.34915526950925
1923,MO,M,23950,5269,29219,18.0327868852459
1923,MS,F,19390,3007,22397,13.425905255168102
1923,MS,M,14366,4403,18769,23.458894986413767
1923,MT,F,3606,578,4184,13.81453154875717
1923,MT,M,3425,800,4225,18.93491124260355
1923,NC,F,33183,6083,39266,15.491774053888859
1923,NC,M,24814,8599,33413,25.735492173704845
1923,ND,F,5886,675,6561,10.2880658436214
1923,ND,M,5103,875,5978,14.637002341920374
1923,NE,F,10914,1360,12274,11.080332409972298
1923,NE,M,10571,1499,12070,12.419221209610605
1923,NH,F,3036,363,3399,10.679611650485436
1923,NH,M,2541,499,3040,16.414473684210527
1923,NJ,F,27361,4284,31645,13.537683678306209
1923,NJ,M,21448,8092,29540,27.393364928909953
1923,NM,F,3536,573,4109,13.944998783158919
1923,NM,M,3176,833,4009,20.77824893988526
1923,NV,F,228,48,276,17.391304347826086
1923,NV,M,236,77,313,24.600638977635782
1923,NY,F,87193,12433,99626,12.479673980687773
1923,NY,M,71050,23243,94293,24.649761912337077
1923,OH,F,47038,8975,56013,16.02306607394712
1923,OH,M,41650,10531,52181,20.181675322435368
1923,OK,F,22242,3102,25344,12.239583333333332
1923,OK,M,18587,3876,22463,17.255041624003916
1923,OR,F,5361,659,6020,10.946843853820598
1923,OR,M,4859,838,5697,14.709496226083903
1923,PA,F,80441,15798,96239,16.415382537225035
1923,PA,M,63601,24800,88401,28.053981289804415
1923,RI,F,4890,815,5705,14.285714285714285
1923,RI,M,3858,1375,5233,26.275558952799543
1923,SC,F,20123,3567,23690,15.05698607007176
1923,SC,M,14006,5669,19675,28.81321473951715
1923,SD,F,5677,688,6365,10.809112333071484
1923,SD,M,5326,822,6148,13.370201691607026
1923,TN,F,23925,4544,28469,15.961220977203276
1923,TN,M,18269,5946,24215,24.555027875283916
1923,TX,F,51794,6431,58225,11.045083726921426
1923,TX,M,42158,9857,52015,18.95030279727002
1923,UT,F,4450,622,5072,12.263406940063092
1923,UT,M,4155,679,4834,14.046338436077782
1923,VA,F,24129,4134,28263,14.626897356968474
1923,VA,M,18216,5706,23922,23.85252069224981
1923,VT,F,2258,307,2565,11.968810916179336
1923,VT,M,2027,371,2398,15.471226021684735
1923,WA,F,8856,1058,9914,10.671777284647971
1923,WA,M,8150,1489,9639,15.447660545699762
1923,WI,F,22272,2591,24863,10.421107670031775
1923,WI,M,20345,3425,23770,14.408918805216658
1923,WV,F,17557,3140,20697,15.171280861960671
1923,WV,M,13646,3583,17229,20.796331766208137
1923,WY,F,1495,253,1748,14.473684210526317
1923,WY,M,1304,331,1635,20.244648318042813
1924,AK,F,124,59,183,32.240437158469945
1924,AK,M,156,103,259,39.768339768339764
1924,AL,F,27622,4902,32524,15.07194687000369
1924,AL,M,19403,6571,25974,25.298375298375298
1924,AR,F,18735,2936,21671,13.548059618845462
1924,AR,M,14423,3942,18365,21.464742717124967
1924,AZ,F,3179,491,3670,13.37874659400545
1924,AZ,M,2953,760,3713,20.468623754376512
1924,CA,F,33881,4008,37889,10.57826809892053
1924,CA,M,30288,6273,36561,17.157626979568395
1924,CO,F,8034,1172,9206,12.730827721051488
1924,CO,M,7321,1504,8825,17.042492917847024
1924,CT,F,11449,1671,13120,12.736280487804876
1924,CT,M,9219,3272,12491,26.19486029941558
1924,DC,F,3287,617,3904,15.804303278688526
1924,DC,M,2300,981,3281,29.89942090825968
1924,DE,F,1382,251,1633,15.370483772198407
1924,DE,M,1047,461,1508,30.57029177718833
1924,FL,F,11537,1798,13335,13.483314585676789
1924,FL,M,8881,2804,11685,23.996576807873343
1924,GA,F,29232,5103,34335,14.862385321100918
1924,GA,M,21046,6827,27873,24.49323718293689
1924,HI,F,3394,266,3660,7.267759562841531
1924,HI,M,2598,633,3231,19.59145775301764
1924,IA,F,19195,2757,21952,12.559220116618075
1924,IA,M,18074,2859,20933,13.657860793961687
1924,ID,F,3397,458,3855,11.880674448767833
1924,ID,M,3138,513,3651,14.050944946589974
1924,IL,F,54516,7691,62207,12.36356037101934
1924,IL,M,48400,11361,59761,19.010726058800888
1924,IN,F,23423,4826,28249,17.08379057665758
1924,IN,M,22012,4880,26892,18.14666071694184
1924,KS,F,14447,2136,16583,12.880660917807393
1924,KS,M,14087,2218,16305,13.603189205765103
1924,KY,F,26453,5261,31714,16.588888188181876
1924,KY,M,21067,5899,26966,21.875695320032634
1924,LA,F,21631,2711,24342,11.137129241639963
1924,LA,M,15131,4245,19376,21.908546655656483
1924,MA,F,32307,5184,37491,13.82731855645355
1924,MA,M,26686,9249,35935,25.738138305273413
1924,MD,F,11910,2494,14404,17.314634823660093
1924,MD,M,10079,3275,13354,24.524487045080125
1924,ME,F,6491,754,7245,10.407177363699102
1924,ME,M,5605,989,6594,14.99848346982105
1924,MI,F,36389,4447,40836,10.889901067685376
1924,MI,M,32327,6595,38922,16.944144699655723
1924,MN,F,20557,2273,22830,9.956197985107314
1924,MN,M,18974,3136,22110,14.183627317955677
1924,MO,F,27597,4554,32151,14.164411682373798
1924,MO,M,25053,5400,30453,17.732243128755787
1924,MS,F,19723,3081,22804,13.510787581126118
1924,MS,M,14099,4393,18492,23.756218905472636
1924,MT,F,3549,548,4097,13.375640712716622
1924,MT,M,3228,790,4018,19.661523145843702
1924,NC,F,34858,6529,41387,15.775485055693817
1924,NC,M,26031,8836,34867,25.342013938681273
1924,ND,F,5821,650,6471,10.04481532993355
1924,ND,M,5217,909,6126,14.838393731635652
1924,NE,F,10995,1423,12418,11.45917216943147
1924,NE,M,10710,1538,12248,12.557152188112344
1924,NH,F,3365,421,3786,11.119915478077127
1924,NH,M,2860,598,3458,17.293233082706767
1924,NJ,F,27749,4240,31989,13.254556253712213
1924,NJ,M,22213,8123,30336,26.776766877637133
1924,NM,F,3661,611,4272,14.30243445692884
1924,NM,M,3110,873,3983,21.91815214662315
1924,NV,F,208,52,260,20.0
1924,NV,M,265,81,346,23.410404624277454
1924,NY,F,89100,12302,101402,12.131910613202896
1924,NY,M,72858,23364,96222,24.28134937955977
1924,OH,F,48663,9197,57860,15.895264431386105
1924,OH,M,43116,10914,54030,20.19988895058301
1924,OK,F,22539,3104,25643,12.104667940568577
1924,OK,M,18998,3818,22816,16.733870967741936
1924,OR,F,5484,730,6214,11.74766655938204
1924,OR,M,5072,928,6000,15.466666666666667
1924,PA,F,83200,16219,99419,16.313783079693017
1924,PA,M,65492,25407,90899,27.950802539081838
1924,RI,F,5092,802,5894,13.607058025110282
1924,RI,M,4205,1403,5608,25.01783166904422
1924,SC,F,20898,3814,24712,15.433797345419228
1924,SC,M,14196,5905,20101,29.376647927963784
1924,SD,F,5651,688,6339,10.853446915917338
1924,SD,M,5367,782,6149,12.717515043096439
1924,TN,F,24947,4947,29894,16.548471265136815
1924,TN,M,19068,6110,25178,24.267217412026373
1924,TX,F,55405,7009,62414,11.229852276732784
1924,TX,M,45810,10342,56152,18.417865792847984
1924,UT,F,4471,573,5044,11.360031720856464
1924,UT,M,4286,691,4977,13.88386578259996
1924,VA,F,24604,4245,28849,14.714548164581096
1924,VA,M,18418,5852,24270,24.112072517511333
1924,VT,F,2353,323,2676,12.070254110612854
1924,VT,M,2081,382,2463,15.509541209906619
1924,WA,F,8890,1001,9891,10.120311394196744
1924,WA,M,8257,1534,9791,15.66744969870289
1924,WI,F,22464,2723,25187,10.81113272720054
1924,WI,M,20814,3656,24470,14.940743767879036
1924,WV,F,18174,3391,21565,15.72455367493624
1924,WV,M,14613,3863,18476,20.90820523922927
1924,WY,F,1493,269,1762,15.266742338251987
1924,WY,M,1415,314,1729,18.160786581839215
1925,AK,F,168,46,214,21.49532710280374
1925,AK,M,113,67,180,37.22222222222222
1925,AL,F,28024,4960,32984,15.037593984962406
1925,AL,M,19939,6683,26622,25.10329802419052
1925,AR,F,18865,2875,21740,13.224471021159154
1925,AR,M,14345,3775,18120,20.833333333333336
1925,AZ,F,3423,471,3894,12.09553158705701
1925,AZ,M,3050,725,3775,19.205298013245034
1925,CA,F,33092,3814,36906,10.33436297620983
1925,CA,M,30300,6292,36592,17.195015303891562
1925,CO,F,7661,1124,8785,12.794536141149687
1925,CO,M,7233,1431,8664,16.51662049861496
1925,CT,F,10674,1558,12232,12.737083060824068
1925,CT,M,9012,3137,12149,25.8210552308832
1925,DC,F,2974,621,3595,17.273991655076497
1925,DC,M,2394,1008,3402,29.629629629629626
1925,DE,F,1308,224,1532,14.621409921671018
1925,DE,M,1061,413,1474,28.01899592944369
1925,FL,F,12859,2071,14930,13.871399866041529
1925,FL,M,10039,3162,13201,23.952730853723203
1925,GA,F,29737,5076,34813,14.580760060896791
1925,GA,M,21399,6977,28376,24.587679729348746
1925,HI,F,3335,268,3603,7.4382459061892865
1925,HI,M,2586,622,3208,19.389027431421447
1925,IA,F,18346,2626,20972,12.521457181003242
1925,IA,M,17657,2871,20528,13.985775526110677
1925,ID,F,3178,438,3616,12.112831858407079
1925,ID,M,2973,484,3457,14.000578536303154
1925,IL,F,52496,7586,60082,12.626077693818448
1925,IL,M,47777,11292,59069,19.116626318373427
1925,IN,F,22302,4546,26848,16.932359952324195
1925,IN,M,20983,4774,25757,18.53476724773848
1925,KS,F,13927,2004,15931,12.57924800703032
1925,KS,M,13598,2203,15801,13.942155559774697
1925,KY,F,25018,4966,29984,16.562166488794023
1925,KY,M,20331,5597,25928,21.586701635297747
1925,LA,F,21140,2636,23776,11.086810228802154
1925,LA,M,15031,4346,19377,22.428652526190845
1925,MA,F,30522,4793,35315,13.5721364859125
1925,MA,M,25380,8849,34229,25.85234742469836
1925,MD,F,11697,2350,14047,16.729550793763792
1925,MD,M,9889,3401,13290,25.590669676448456
1925,ME,F,5890,694,6584,10.540704738760631
1925,ME,M,5512,934,6446,14.48960595718275
1925,MI,F,36456,4464,40920,10.909090909090908
1925,MI,M,32759,6661,39420,16.897513952308472
1925,MN,F,19654,2194,21848,10.042109117539363
1925,MN,M,18289,3151,21440,14.696828358208954
1925,MO,F,26922,4356,31278,13.926721657394975
1925,MO,M,24425,5239,29664,17.661138079827403
1925,MS,F,19964,3181,23145,13.743789155325123
1925,MS,M,14593,4497,19090,23.55683603981142
1925,MT,F,3361,491,3852,12.7466251298027
1925,MT,M,3179,824,4003,20.584561578815887
1925,NC,F,33695,6041,39736,15.202838735655325
1925,NC,M,25589,8542,34131,25.027101462014006
1925,ND,F,5577,596,6173,9.654948971326746
1925,ND,M,5257,902,6159,14.645234616009093
1925,NE,F,10554,1278,11832,10.801217038539553
1925,NE,M,10370,1499,11869,12.629539135563231
1925,NH,F,3111,345,3456,9.98263888888889
1925,NH,M,2729,573,3302,17.353119321623257
1925,NJ,F,27126,3985,31111,12.80897431776542
1925,NJ,M,21628,8098,29726,27.242144923635873
1925,NM,F,3776,601,4377,13.730865889878913
1925,NM,M,3050,843,3893,21.65425122013871
1925,NV,F,209,62,271,22.878228782287824
1925,NV,M,247,63,310,20.32258064516129
1925,NY,F,88211,11858,100069,11.849823621701026
1925,NY,M,72377,23317,95694,24.366208957719397
1925,OH,F,46661,8554,55215,15.492166983609525
1925,OH,M,42224,10866,53090,20.467131286494634
1925,OK,F,22798,3066,25864,11.854314877822455
1925,OK,M,19242,3722,22964,16.20797770423271
1925,OR,F,5311,628,5939,10.57417073581411
1925,OR,M,5070,901,5971,15.089599732038184
1925,PA,F,79986,14770,94756,15.587403436194014
1925,PA,M,63800,24536,88336,27.775765259916678
1925,RI,F,4946,744,5690,13.075571177504393
1925,RI,M,4007,1377,5384,25.575780089153042
1925,SC,F,20490,3548,24038,14.759963391297113
1925,SC,M,13824,5406,19230,28.112324492979717
1925,SD,F,5282,662,5944,11.13728129205922
1925,SD,M,5135,727,5862,12.401910610713067
1925,TN,F,24421,4680,29101,16.08192158345074
1925,TN,M,18647,5696,24343,23.398923715236414
1925,TX,F,54979,6725,61704,10.898807208608842
1925,TX,M,45032,10312,55344,18.63255276091356
1925,UT,F,4431,542,4973,10.898853810577117
1925,UT,M,4387,674,5061,13.31752618059672
1925,VA,F,23766,3984,27750,14.356756756756756
1925,VA,M,17655,5675,23330,24.324903557651094
1925,VT,F,2307,302,2609,11.57531621310847
1925,VT,M,2122,366,2488,14.710610932475884
1925,WA,F,8789,1009,9798,10.298020004082465
1925,WA,M,8373,1463,9836,14.873932492883284
1925,WI,F,21441,2744,24185,11.34587554269175
1925,WI,M,20234,3571,23805,15.001050199537913
1925,WV,F,17389,3163,20552,15.390229661346828
1925,WV,M,14083,3547,17630,20.119115144639817
1925,WY,F,1395,253,1648,15.351941747572814
1925,WY,M,1348,324,1672,19.37799043062201
1926,AK,F,146,74,220,33.63636363636363
1926,AK,M,101,87,188,46.27659574468085
1926,AL,F,27884,4632,32516,14.245294624185018
1926,AL,M,20780,6781,27561,24.603606545480933
1926,AR,F,17974,2652,20626,12.85755842140987
1926,AR,M,14516,3807,18323,20.777165311357308
1926,AZ,F,3403,473,3876,12.20330237358101
1926,AZ,M,3067,713,3780,18.86243386243386
1926,CA,F,32479,3640,36119,10.077798388659707
1926,CA,M,30672,6136,36808,16.670289067594002
1926,CO,F,7174,1127,8301,13.576677508733887
1926,CO,M,6647,1419,8066,17.592363005207044
1926,CT,F,10568,1598,12166,13.134966299523262
1926,CT,M,8663,3144,11807,26.62827136444482
1926,DC,F,2925,537,3462,15.511265164644714
1926,DC,M,2434,948,3382,28.0307510348906
1926,DE,F,1251,239,1490,16.040268456375838
1926,DE,M,1088,408,1496,27.27272727272727
1926,FL,F,14588,2150,16738,12.845023300274825
1926,FL,M,11823,3457,15280,22.62434554973822
1926,GA,F,27121,4593,31714,14.482562905972127
1926,GA,M,20678,6385,27063,23.593097587111554
1926,HI,F,3261,268,3529,7.594219325587985
1926,HI,M,2503,614,3117,19.69842797561758
1926,IA,F,17410,2463,19873,12.393699994968047
1926,IA,M,17181,2769,19950,13.8796992481203
1926,ID,F,3130,383,3513,10.90236265300313
1926,ID,M,3075,496,3571,13.889666760011202
1926,IL,F,52333,7197,59530,12.089702670922224
1926,IL,M,47038,10930,57968,18.855230471984544
1926,IN,F,21919,4209,26128,16.109154929577464
1926,IN,M,21035,4821,25856,18.645575495049506
1926,KS,F,13328,1963,15291,12.837616898829376
1926,KS,M,13167,1988,15155,13.117782909930717
1926,KY,F,23802,4707,28509,16.510575607702833
1926,KY,M,19963,5600,25563,21.906661972381958
1926,LA,F,21123,2691,23814,11.300075585789871
1926,LA,M,15510,4397,19907,22.0877078414628
1926,MA,F,30203,4499,34702,12.964670624171518
1926,MA,M,25366,8531,33897,25.167418945629404
1926,MD,F,11286,2250,13536,16.622340425531913
1926,MD,M,9888,3191,13079,24.397889746922548
1926,ME,F,5833,653,6486,10.067838421214924
1926,ME,M,5118,945,6063,15.586343394359229
1926,MI,F,36369,4576,40945,11.175967761631457
1926,MI,M,33949,6999,40948,17.092409885708705
1926,MN,F,19375,2311,21686,10.656644839988932
1926,MN,M,18359,3152,21511,14.652968248802939
1926,MO,F,26082,4170,30252,13.784212614042046
1926,MO,M,24398,5115,29513,17.33134550875885
1926,MS,F,20573,3138,23711,13.234363797393614
1926,MS,M,15367,4921,20288,24.255717665615144
1926,MT,F,3296,477,3773,12.64245958123509
1926,MT,M,3079,724,3803,19.037601893242176
1926,NC,F,32513,5892,38405,15.341752375992709
1926,NC,M,25594,8427,34021,24.76999500308633
1926,ND,F,5643,635,6278,10.114686205798025
1926,ND,M,5443,906,6349,14.26996377382265
1926,NE,F,10119,1195,11314,10.562135407459785
1926,NE,M,10270,1409,11679,12.064389074407057
1926,NH,F,2911,369,3280,11.25
1926,NH,M,2586,566,3152,17.956852791878173
1926,NJ,F,26723,3752,30475,12.311730926989336
1926,NJ,M,22058,8012,30070,26.644496175590287
1926,NM,F,3404,549,3953,13.88818618770554
1926,NM,M,2952,766,3718,20.602474448628293
1926,NV,F,201,40,241,16.59751037344398
1926,NV,M,238,70,308,22.727272727272727
1926,NY,F,87050,11501,98551,11.670099745309535
1926,NY,M,72949,23334,96283,24.234807806154773
1926,OH,F,46106,8217,54323,15.12618964342912
1926,OH,M,42072,10588,52660,20.106342575009496
1926,OK,F,22055,2958,25013,11.825850557709991
1926,OK,M,19030,3647,22677,16.082374211756406
1926,OR,F,5058,566,5624,10.064011379800855
1926,OR,M,4972,841,5813,14.467572681919835
1926,PA,F,77487,14008,91495,15.31012623640636
1926,PA,M,63583,23706,87289,27.158061153180814
1926,RI,F,4795,649,5444,11.92138133725202
1926,RI,M,3981,1337,5318,25.141030462579916
1926,SC,F,18466,3480,21946,15.857103800236946
1926,SC,M,13152,5176,18328,28.240942819729376
1926,SD,F,5269,626,5895,10.61916878710772
1926,SD,M,5180,694,5874,11.814776983316309
1926,TN,F,22838,4316,27154,15.894527509759152
1926,TN,M,18242,5739,23981,23.931445727867896
1926,TX,F,53253,6548,59801,10.949649671410178
1926,TX,M,44956,10038,54994,18.25290031639815
1926,UT,F,4264,565,4829,11.700144957548146
1926,UT,M,4193,612,4805,12.736732570239335
1926,VA,F,22289,3750,26039,14.401474711010406
1926,VA,M,17018,5159,22177,23.26283987915408
1926,VT,F,2223,280,2503,11.186576108669597
1926,VT,M,2057,356,2413,14.75341898052217
1926,WA,F,8605,935,9540,9.80083857442348
1926,WA,M,7978,1449,9427,15.370743608783282
1926,WI,F,21178,2542,23720,10.716694772344013
1926,WI,M,20024,3700,23724,15.596020907098296
1926,WV,F,16991,2955,19946,14.815000501353657
1926,WV,M,14091,3466,17557,19.741413681152817
1926,WY,F,1281,232,1513,15.33377395902181
1926,WY,M,1179,297,1476,20.121951219512198
1927,AK,F,166,44,210,20.952380952380953
1927,AK,M,144,88,232,37.93103448275862
1927,AL,F,28210,4802,33012,14.546225614927904
1927,AL,M,21623,6696,28319,23.644902715491366
1927,AR,F,17612,2650,20262,13.078669430460963
1927,AR,M,14420,3622,18042,20.075379669659682
1927,AZ,F,3318,512,3830,13.368146214099216
1927,AZ,M,3284,768,4052,18.95360315893386
1927,CA,F,33172,3613,36785,9.821938290063885
1927,CA,M,31092,6328,37420,16.910742918225548
1927,CO,F,7422,1025,8447,12.1344856161951
1927,CO,M,6808,1413,8221,17.18769006203625
1927,CT,F,10482,1462,11944,12.24045545880777
1927,CT,M,8924,3008,11932,25.209520616828694
1927,DC,F,3034,567,3601,15.745626214940295
1927,DC,M,2486,978,3464,28.23325635103926
1927,DE,F,1307,263,1570,16.751592356687897
1927,DE,M,1046,389,1435,27.108013937282234
1927,FL,F,13791,2064,15855,13.017975402081364
1927,FL,M,11248,3345,14593,22.921948879599807
1927,GA,F,28035,4639,32674,14.197833139499297
1927,GA,M,21804,6706,28510,23.521571378463697
1927,HI,F,3436,272,3708,7.335490830636461
1927,HI,M,2616,628,3244,19.35881627620222
1927,IA,F,17161,2500,19661,12.715528203041554
1927,IA,M,17036,2714,19750,13.741772151898735
1927,ID,F,3077,379,3456,10.966435185185185
1927,ID,M,3122,461,3583,12.866313145408876
1927,IL,F,51670,7418,59088,12.554156512320608
1927,IL,M,47747,11278,59025,19.107157983905125
1927,IN,F,21934,4285,26219,16.343109958427096
1927,IN,M,21366,4603,25969,17.724979783588125
1927,KS,F,13111,1940,15051,12.889509002724072
1927,KS,M,13268,1952,15220,12.825229960578186
1927,KY,F,24540,4807,29347,16.379868470371758
1927,KY,M,20975,5655,26630,21.235448742020278
1927,LA,F,21035,2673,23708,11.27467521511726
1927,LA,M,15739,4582,20321,22.548102947689582
1927,MA,F,29918,4441,34359,12.925288861724729
1927,MA,M,25461,8490,33951,25.006627198020677
1927,MD,F,11577,2321,13898,16.700244639516477
1927,MD,M,9475,3174,12649,25.092892718791997
1927,ME,F,5715,665,6380,10.423197492163009
1927,ME,M,5217,925,6142,15.060240963855422
1927,MI,F,37310,4557,41867,10.884467480354456
1927,MI,M,34891,7066,41957,16.84105155278023
1927,MN,F,18822,2200,21022,10.46522690514699
1927,MN,M,17954,3196,21150,15.11111111111111
1927,MO,F,25868,4319,30187,14.307483353761551
1927,MO,M,24075,5041,29116,17.31350460228053
1927,MS,F,20436,3212,23648,13.58254397834912
1927,MS,M,15855,4802,20657,23.246357167062012
1927,MT,F,3238,438,3676,11.91512513601741
1927,MT,M,3188,683,3871,17.644019633169723
1927,NC,F,33269,5897,39166,15.056426492365826
1927,NC,M,26620,8534,35154,24.27604255561245
1927,ND,F,5606,651,6257,10.404347131213042
1927,ND,M,5379,864,6243,13.839500240269102
1927,NE,F,10071,1278,11349,11.2609040444092
1927,NE,M,10228,1478,11706,12.626003758756193
1927,NH,F,3005,299,3304,9.049636803874092
1927,NH,M,2711,537,3248,16.533251231527093
1927,NJ,F,27209,3850,31059,12.395762902862293
1927,NJ,M,22050,7964,30014,26.53428400079963
1927,NM,F,3621,567,4188,13.53868194842407
1927,NM,M,3311,870,4181,20.808419038507534
1927,NV,F,232,49,281,17.437722419928825
1927,NV,M,282,85,367,23.160762942779293
1927,NY,F,88927,11849,100776,11.757759784075574
1927,NY,M,74201,23844,98045,24.319445152735987
1927,OH,F,46598,8371,54969,15.22858338336153
1927,OH,M,42365,10607,52972,20.023786151174207
1927,OK,F,21795,3054,24849,12.290233007364481
1927,OK,M,19447,3522,22969,15.333710653489485
1927,OR,F,4997,586,5583,10.496149023822317
1927,OR,M,4994,834,5828,14.31022649279341
1927,PA,F,77808,14077,91885,15.320237253088099
1927,PA,M,64216,23839,88055,27.07285219465107
1927,RI,F,4671,683,5354,12.756817332835263
1927,RI,M,4019,1316,5335,24.667291471415183
1927,SC,F,18408,3452,21860,15.791399817017385
1927,SC,M,13218,5179,18397,28.151329021036037
1927,SD,F,4760,547,5307,10.307141511211608
1927,SD,M,4973,633,5606,11.291473421334285
1927,TN,F,23411,4522,27933,16.18873733576773
1927,TN,M,19253,5788,25041,23.11409288766423
1927,TX,F,54059,6497,60556,10.72891208137922
1927,TX,M,46945,10020,56965,17.58974809093303
1927,UT,F,4195,490,4685,10.458911419423693
1927,UT,M,4254,610,4864,12.541118421052634
1927,VA,F,22285,3690,25975,14.205967276227142
1927,VA,M,17741,5384,23125,23.282162162162162
1927,VT,F,2176,269,2445,11.002044989775051
1927,VT,M,2144,418,2562,16.315378610460577
1927,WA,F,8333,1006,9339,10.772031266730913
1927,WA,M,7979,1446,9425,15.342175066312997
1927,WI,F,21637,2795,24432,11.439914865749836
1927,WI,M,20651,3827,24478,15.63444725876297
1927,WV,F,17302,3064,20366,15.04468231366002
1927,WV,M,14717,3602,18319,19.662645340902888
1927,WY,F,1254,221,1475,14.983050847457626
1927,WY,M,1290,289,1579,18.30272324255858
1928,AK,F,165,52,217,23.963133640552993
1928,AK,M,173,86,259,33.204633204633204
1928,AL,F,26488,4648,31136,14.928057553956833
1928,AL,M,20729,6489,27218,23.840840620177822
1928,AR,F,16099,2417,18516,13.053575286238928
1928,AR,M,13575,3295,16870,19.531713100177832
1928,AZ,F,3461,494,3955,12.490518331226296
1928,AZ,M,3423,803,4226,19.001419782300047
1928,CA,F,33178,3559,36737,9.68778071154422
1928,CA,M,31358,6174,37532,16.449962698497284
1928,CO,F,7362,1031,8393,12.284046229000358
1928,CO,M,7220,1393,8613,16.173226518054104
1928,CT,F,10379,1380,11759,11.735691810528106
1928,CT,M,8875,3019,11894,25.382545821422564
1928,DC,F,2964,518,3482,14.876507754164273
1928,DC,M,2391,899,3290,27.325227963525833
1928,DE,F,1273,240,1513,15.862524785194976
1928,DE,M,1055,415,1470,28.2312925170068
1928,FL,F,11799,1884,13683,13.768910326682745
1928,FL,M,10042,3036,13078,23.214558801039914
1928,GA,F,26991,4416,31407,14.060559747826918
1928,GA,M,21583,6571,28154,23.33948994814236
1928,HI,F,3232,289,3521,8.207895484237431
1928,HI,M,2750,716,3466,20.657818811309866
1928,IA,F,16540,2293,18833,12.175436733393513
1928,IA,M,16757,2705,19462,13.898879868461616
1928,ID,F,3131,376,3507,10.721414314228687
1928,ID,M,3111,423,3534,11.96943972835314
1928,IL,F,50341,6958,57299,12.143318382519764
1928,IL,M,46725,10916,57641,18.93790878020853
1928,IN,F,21301,3966,25267,15.696362844817353
1928,IN,M,20886,4673,25559,18.283187918150162
1928,KS,F,12411,1749,14160,12.351694915254237
1928,KS,M,12963,1868,14831,12.595239700627065
1928,KY,F,23343,4414,27757,15.902294916597615
1928,KY,M,20459,5247,25706,20.411577063720532
1928,LA,F,19161,2457,21618,11.365528726061616
1928,LA,M,15227,3984,19211,20.73811878611212
1928,MA,F,29184,4189,33373,12.552063044976478
1928,MA,M,24735,8437,33172,25.434101049077533
1928,MD,F,11168,2196,13364,16.43220592636935
1928,MD,M,9615,3004,12619,23.805372850463584
1928,ME,F,5852,615,6467,9.509819081490644
1928,ME,M,5361,910,6271,14.511242226120235
1928,MI,F,36492,4681,41173,11.369101109950694
1928,MI,M,34727,7080,41807,16.934963044466237
1928,MN,F,18336,2083,20419,10.201283118663989
1928,MN,M,17435,3063,20498,14.942921260610792
1928,MO,F,24638,3992,28630,13.943415997205728
1928,MO,M,23230,4661,27891,16.711483991251658
1928,MS,F,19377,3050,22427,13.599678958398359
1928,MS,M,15484,4461,19945,22.36650789671597
1928,MT,F,3353,443,3796,11.67017913593256
1928,MT,M,3302,746,4048,18.42885375494071
1928,NC,F,32457,5741,38198,15.029582700664957
1928,NC,M,26265,8116,34381,23.606061487449466
1928,ND,F,5708,606,6314,9.597719353816915
1928,ND,M,5410,878,6288,13.963104325699746
1928,NE,F,10067,1203,11270,10.67435669920142
1928,NE,M,10257,1347,11604,11.608066184074458
1928,NH,F,3006,327,3333,9.810981098109812
1928,NH,M,2609,548,3157,17.358251504592968
1928,NJ,F,26253,3811,30064,12.676290580095795
1928,NJ,M,21851,7537,29388,25.646522390091192
1928,NM,F,3737,548,4285,12.78879813302217
1928,NM,M,3575,857,4432,19.33664259927798
1928,NV,F,179,31,210,14.761904761904763
1928,NV,M,250,54,304,17.763157894736842
1928,NY,F,87570,11197,98767,11.33678252857736
1928,NY,M,74004,23856,97860,24.377682403433475
1928,OH,F,44608,8274,52882,15.646155591694717
1928,OH,M,41925,10658,52583,20.268908202270698
1928,OK,F,20874,2721,23595,11.532104259376986
1928,OK,M,19500,3369,22869,14.731732913551095
1928,OR,F,5030,522,5552,9.402017291066283
1928,OR,M,4852,804,5656,14.214992927864214
1928,PA,F,74467,13048,87515,14.90944409529795
1928,PA,M,61584,22451,84035,26.716249181888497
1928,RI,F,4554,607,5161,11.761286572369697
1928,RI,M,3885,1189,5074,23.433188805675993
1928,SC,F,17816,3238,21054,15.379500332478388
1928,SC,M,13253,5113,18366,27.839486006751606
1928,SD,F,5008,559,5567,10.041314891323873
1928,SD,M,5110,632,5742,11.006617903169627
1928,TN,F,22647,4190,26837,15.61277340984462
1928,TN,M,18703,5483,24186,22.67013975026875
1928,TX,F,53867,6364,60231,10.565987614351414
1928,TX,M,48100,9924,58024,17.10326761340135
1928,UT,F,4097,470,4567,10.291219619005911
1928,UT,M,4208,650,4858,13.379991766158913
1928,VA,F,21463,3535,24998,14.141131290503239
1928,VA,M,17521,5111,22632,22.58306822198657
1928,VT,F,2376,282,2658,10.609480812641085
1928,VT,M,1981,424,2405,17.62993762993763
1928,WA,F,8418,901,9319,9.668419358300246
1928,WA,M,8121,1407,9528,14.767002518891687
1928,WI,F,21475,2654,24129,10.9992125657922
1928,WI,M,20844,3940,24784,15.897353131052292
1928,WV,F,16633,2879,19512,14.755022550225503
1928,WV,M,14506,3480,17986,19.34838207494718
1928,WY,F,1220,225,1445,15.570934256055363
1928,WY,M,1353,255,1608,15.858208955223882
1929,AK,F,128,45,173,26.011560693641616
1929,AK,M,142,75,217,34.56221198156682
1929,AL,F,25632,4379,30011,14.591316517276997
1929,AL,M,20471,6344,26815,23.65840014917024
1929,AR,F,15880,2356,18236,12.919499890326827
1929,AR,M,13377,3289,16666,19.734789391575664
1929,AZ,F,3761,501,4262,11.755044580009386
1929,AZ,M,3672,738,4410,16.73469387755102
1929,CA,F,32257,3457,35714,9.6796774374195
1929,CA,M,30341,6023,36364,16.563084369156307
1929,CO,F,7315,980,8295,11.814345991561181
1929,CO,M,6933,1347,8280,16.268115942028984
1929,CT,F,9826,1315,11141,11.803249259491967
1929,CT,M,8488,2937,11425,25.706783369803066
1929,DC,F,2965,457,3422,13.354763296317943
1929,DC,M,2399,933,3332,28.00120048019208
1929,DE,F,1251,234,1485,15.757575757575756
1929,DE,M,977,416,1393,29.863603732950466
1929,FL,F,10693,1585,12278,12.909268610522886
1929,FL,M,8933,2632,11565,22.75832252485949
1929,GA,F,25780,4267,30047,14.201084966885213
1929,GA,M,20727,6225,26952,23.096616206589495
1929,HI,F,3257,257,3514,7.313602731929425
1929,HI,M,2554,677,3231,20.953265242958835
1929,IA,F,16321,2217,18538,11.959218901715396
1929,IA,M,16299,2587,18886,13.697977337710473
1929,ID,F,2930,361,3291,10.969310240048618
1929,ID,M,3071,446,3517,12.681262439579186
1929,IL,F,50419,6638,57057,11.633980055032685
1929,IL,M,46023,11061,57084,19.376708009249526
1929,IN,F,21082,3596,24678,14.571683280654835
1929,IN,M,20424,4624,25048,18.460555732992653
1929,KS,F,12280,1730,14010,12.348322626695216
1929,KS,M,12461,1845,14306,12.896686704879071
1929,KY,F,22399,4057,26456,15.33489567583913
1929,KY,M,19506,5057,24563,20.58787607376949
1929,LA,F,19021,2402,21423,11.212248517948
1929,LA,M,15031,3967,18998,20.881145383724604
1929,MA,F,27767,3752,31519,11.903930962276723
1929,MA,M,23466,7996,31462,25.414786091157588
1929,MD,F,10613,1955,12568,15.55537873965627
1929,MD,M,9149,2911,12060,24.137645107794363
1929,ME,F,5722,591,6313,9.361634722002217
1929,ME,M,5103,848,5951,14.249705931776171
1929,MI,F,37463,4561,42024,10.853321911288788
1929,MI,M,34699,7429,42128,17.634352449677174
1929,MN,F,17133,2065,19198,10.756328784248359
1929,MN,M,16490,3129,19619,15.948825118507571
1929,MO,F,24032,3628,27660,13.116413593637022
1929,MO,M,22527,4655,27182,17.125303509675522
1929,MS,F,18621,2863,21484,13.326196239061627
1929,MS,M,14685,4179,18864,22.153307888040715
1929,MT,F,3356,435,3791,11.474544974940649
1929,MT,M,3290,699,3989,17.523188769115066
1929,NC,F,30505,5375,35880,14.980490523968784
1929,NC,M,25317,7869,33186,23.71180618333032
1929,ND,F,5540,580,6120,9.477124183006536
1929,ND,M,5431,804,6235,12.89494787489976
1929,NE,F,9441,1166,10607,10.992740642971622
1929,NE,M,9950,1410,11360,12.411971830985916
1929,NH,F,2835,279,3114,8.959537572254336
1929,NH,M,2670,513,3183,16.116870876531575
1929,NJ,F,25696,3473,29169,11.906476053344305
1929,NJ,M,21270,7673,28943,26.510727982586463
1929,NM,F,3503,620,4123,15.037593984962406
1929,NM,M,3503,774,4277,18.096796820201074
1929,NV,F,190,43,233,18.4549356223176
1929,NV,M,232,68,300,22.666666666666664
1929,NY,F,85800,10791,96591,11.17184830884865
1929,NY,M,71832,23300,95132,24.49228440482698
1929,OH,F,44057,7314,51371,14.237604874345447
1929,OH,M,40154,10597,50751,20.880376741344996
1929,OK,F,20227,2567,22794,11.261735544441521
1929,OK,M,18665,3158,21823,14.470970993905514
1929,OR,F,4658,510,5168,9.868421052631579
1929,OR,M,4623,822,5445,15.096418732782368
1929,PA,F,70766,12152,82918,14.65544272654912
1929,PA,M,58940,21372,80312,26.611216256599263
1929,RI,F,4332,577,4909,11.753921368914238
1929,RI,M,3524,1106,4630,23.88768898488121
1929,SC,F,16442,2963,19405,15.269260499871168
1929,SC,M,12454,4569,17023,26.8401574340598
1929,SD,F,4796,582,5378,10.821866865005578
1929,SD,M,5046,654,5700,11.473684210526315
1929,TN,F,21858,3875,25733,15.058485213539036
1929,TN,M,18915,5386,24301,22.163696967202995
1929,TX,F,54166,6164,60330,10.21713906845682
1929,TX,M,48048,9854,57902,17.018410417602155
1929,UT,F,4102,429,4531,9.468108585301257
1929,UT,M,4046,599,4645,12.895586652314318
1929,VA,F,20514,3235,23749,13.621626173733631
1929,VA,M,16920,4864,21784,22.328314359162686
1929,VT,F,2296,241,2537,9.499408750492707
1929,VT,M,2006,403,2409,16.72893316728933
1929,WA,F,8225,895,9120,9.81359649122807
1929,WA,M,7994,1383,9377,14.74885357790338
1929,WI,F,21087,2649,23736,11.160262891809909
1929,WI,M,20006,3968,23974,16.551263869191622
1929,WV,F,15545,2618,18163,14.413918405549744
1929,WV,M,13524,3207,16731,19.168011475703782
1929,WY,F,1280,188,1468,12.806539509536785
1929,WY,M,1320,261,1581,16.508538899430743
1930,AK,F,169,53,222,23.873873873873876
1930,AK,M,204,94,298,31.543624161073826
1930,AL,F,25597,4349,29946,14.522807720563682
1930,AL,M,20560,6247,26807,23.303614727496548
1930,AR,F,16415,2530,18945,13.354447083663235
1930,AR,M,14148,3292,17440,18.876146788990823
1930,AZ,F,3868,515,4383,11.749942961441935
1930,AZ,M,3897,820,4717,17.383930464278144
1930,CA,F,33736,3517,37253,9.440850401309962
1930,CA,M,31725,6333,38058,16.640390982185085
1930,CO,F,7341,977,8318,11.745611925943736
1930,CO,M,7119,1319,8438,15.631666271628347
1930,CT,F,10004,1322,11326,11.672258520218966
1930,CT,M,8551,2943,11494,25.604663302592655
1930,DC,F,2924,505,3429,14.727325750947799
1930,DC,M,2615,974,3589,27.13847868487044
1930,DE,F,1322,207,1529,13.53826030085023
1930,DE,M,1126,450,1576,28.553299492385786
1930,FL,F,10505,1588,12093,13.131563714545605
1930,FL,M,9150,2697,11847,22.76525702709547
1930,GA,F,26097,4220,30317,13.919583072203714
1930,GA,M,21697,6471,28168,22.97287702357285
1930,HI,F,3176,278,3454,8.048639258830342
1930,HI,M,2605,725,3330,21.77177177177177
1930,IA,F,16444,2278,18722,12.167503471851298
1930,IA,M,16658,2771,19429,14.262185392969274
1930,ID,F,3105,339,3444,9.843205574912892
1930,ID,M,3104,394,3498,11.26357918810749
1930,IL,F,50449,6746,57195,11.79473730221173
1930,IL,M,46621,11277,57898,19.477356730802445
1930,IN,F,21415,3686,25101,14.68467391737381
1930,IN,M,20790,4773,25563,18.67151742753198
1930,KS,F,12447,1697,14144,11.998020361990951
1930,KS,M,13022,1925,14947,12.878838562922326
1930,KY,F,23123,4168,27291,15.272434135795685
1930,KY,M,20446,5198,25644,20.269848697551083
1930,LA,F,18901,2258,21159,10.67158183278983
1930,LA,M,14959,4005,18964,21.118962244252266
1930,MA,F,27945,3740,31685,11.803692599021618
1930,MA,M,23303,8144,31447,25.89754189588832
1930,MD,F,10585,1950,12535,15.556441962504985
1930,MD,M,9129,3071,12200,25.172131147540984
1930,ME,F,5877,563,6440,8.742236024844722
1930,ME,M,5365,908,6273,14.474732982623944
1930,MI,F,37512,4524,42036,10.762203825292605
1930,MI,M,34758,7631,42389,18.002311920545424
1930,MN,F,17561,2015,19576,10.293216183081325
1930,MN,M,16950,3219,20169,15.96013684367098
1930,MO,F,24214,3723,27937,13.326413000680102
1930,MO,M,23436,4742,28178,16.82873163460856
1930,MS,F,19094,2985,22079,13.519634041396802
1930,MS,M,15766,4553,20319,22.4075987991535
1930,MT,F,3326,402,3728,10.783261802575108
1930,MT,M,3204,680,3884,17.507723995880536
1930,NC,F,30434,5013,35447,14.142240528112392
1930,NC,M,25615,7718,33333,23.154231542315422
1930,ND,F,5347,562,5909,9.510915552546964
1930,ND,M,5281,839,6120,13.709150326797387
1930,NE,F,9755,1155,10910,10.586617781851512
1930,NE,M,9950,1447,11397,12.696323593928227
1930,NH,F,2847,303,3150,9.619047619047619
1930,NH,M,2629,580,3209,18.074166406980368
1930,NJ,F,25957,3450,29407,11.731900567891998
1930,NJ,M,21362,7732,29094,26.575926307829796
1930,NM,F,3952,608,4560,13.333333333333334
1930,NM,M,3701,799,4500,17.755555555555556
1930,NV,F,257,43,300,14.333333333333334
1930,NV,M,271,59,330,17.87878787878788
1930,NY,F,85211,10653,95864,11.112617875323375
1930,NY,M,72201,23275,95476,24.37785412040722
1930,OH,F,44741,7348,52089,14.10662519917833
1930,OH,M,41052,10796,51848,20.822403950007715
1930,OK,F,21147,2621,23768,11.027431841130934
1930,OK,M,19880,3392,23272,14.575455482983843
1930,OR,F,4721,520,5241,9.921770654455257
1930,OR,M,4723,808,5531,14.60856987886458
1930,PA,F,70521,11508,82029,14.029184800497385
1930,PA,M,59629,21604,81233,26.595102975391775
1930,RI,F,4257,561,4818,11.643835616438356
1930,RI,M,3668,1159,4827,24.010772736689457
1930,SC,F,16842,2996,19838,15.102328863796755
1930,SC,M,12994,4694,17688,26.537765716870194
1930,SD,F,5082,568,5650,10.053097345132743
1930,SD,M,5059,684,5743,11.910151488768935
1930,TN,F,22782,4073,26855,15.166635635822006
1930,TN,M,19579,5543,25122,22.064326088687206
1930,TX,F,53360,6163,59523,10.353980814139073
1930,TX,M,48904,10090,58994,17.1034342475506
1930,UT,F,4346,430,4776,9.003350083752094
1930,UT,M,4307,632,4939,12.796112573395424
1930,VA,F,20734,3289,24023,13.691046080839195
1930,VA,M,17351,4865,22216,21.898631616852718
1930,VT,F,2277,261,2538,10.28368794326241
1930,VT,M,2112,444,2556,17.370892018779344
1930,WA,F,8590,859,9449,9.090909090909092
1930,WA,M,8175,1386,9561,14.49639159083778
1930,WI,F,21532,2598,24130,10.766680480729383
1930,WI,M,20292,4246,24538,17.30377373869101
1930,WV,F,15838,2529,18367,13.769260086023847
1930,WV,M,13798,3342,17140,19.498249708284714
1930,WY,F,1319,193,1512,12.764550264550264
1930,WY,M,1302,271,1573,17.22822631913541
1931,AK,F,102,62,164,37.80487804878049
1931,AK,M,160,79,239,33.054393305439326
1931,AL,F,24320,4149,28469,14.57374688257403
1931,AL,M,20101,5696,25797,22.08008683180215
1931,AR,F,15315,2259,17574,12.854216456128373
1931,AR,M,13269,3127,16396,19.071724810929496
1931,AZ,F,3413,480,3893,12.329822758797842
1931,AZ,M,3315,737,4052,18.188548864758143
1931,CA,F,31876,3216,35092,9.164481933204149
1931,CA,M,30204,6157,36361,16.932977640878963
1931,CO,F,7165,928,8093,11.466699616952921
1931,CO,M,7153,1321,8474,15.588860042482889
1931,CT,F,9264,1087,10351,10.5014008308376
1931,CT,M,8014,2659,10673,24.913332708704207
1931,DC,F,3144,419,3563,11.759753017120405
1931,DC,M,2582,929,3511,26.459698091711765
1931,DE,F,1249,178,1427,12.473721093202522
1931,DE,M,1051,408,1459,27.96435915010281
1931,FL,F,10214,1508,11722,12.864698856850367
1931,FL,M,8813,2429,11242,21.606475716064757
1931,GA,F,25500,4080,29580,13.793103448275861
1931,GA,M,21320,5965,27285,21.861828843687007
1931,HI,F,3063,268,3331,8.045631942359652
1931,HI,M,2479,728,3207,22.700342999688182
1931,IA,F,16227,2069,18296,11.308482728465238
1931,IA,M,16259,2696,18955,14.223160116064362
1931,ID,F,3145,338,3483,9.704277921332185
1931,ID,M,2987,449,3436,13.067520372526193
1931,IL,F,46722,6002,52724,11.383810029588043
1931,IL,M,43019,10884,53903,20.191826057918856
1931,IN,F,20286,3387,23673,14.307438854391078
1931,IN,M,19393,4449,23842,18.660347286301484
1931,KS,F,12387,1651,14038,11.760934606069242
1931,KS,M,12459,1902,14361,13.244203049926886
1931,KY,F,22050,3938,25988,15.153147606587655
1931,KY,M,19765,4981,24746,20.128505617069425
1931,LA,F,17999,2214,20213,10.953346855983773
1931,LA,M,14481,3947,18428,21.41849359670067
1931,MA,F,26529,3392,29921,11.336519501353564
1931,MA,M,22001,7754,29755,26.05948580070576
1931,MD,F,10021,1785,11806,15.119430797899373
1931,MD,M,8811,2810,11621,24.180363135702606
1931,ME,F,5784,580,6364,9.113764927718417
1931,ME,M,5369,924,6293,14.68298109010011
1931,MI,F,34468,4050,38518,10.514564619139104
1931,MI,M,32092,6847,38939,17.583913300290195
1931,MN,F,17693,1930,19623,9.835397237935076
1931,MN,M,16662,3244,19906,16.296593991761277
1931,MO,F,23504,3476,26980,12.883617494440324
1931,MO,M,22691,4476,27167,16.475871461699857
1931,MS,F,17437,2643,20080,13.162350597609562
1931,MS,M,14149,3967,18116,21.89776992713623
1931,MT,F,3076,347,3423,10.137306456324861
1931,MT,M,3183,621,3804,16.32492113564669
1931,NC,F,28922,4818,33740,14.279786603438055
1931,NC,M,24557,7082,31639,22.383766870002212
1931,ND,F,5400,528,5928,8.906882591093117
1931,ND,M,4988,864,5852,14.764183185235815
1931,NE,F,9624,1081,10705,10.098085007006071
1931,NE,M,10033,1318,11351,11.611311778697912
1931,NH,F,2657,273,2930,9.31740614334471
1931,NH,M,2472,526,2998,17.545030020013343
1931,NJ,F,24512,2996,27508,10.891377053947943
1931,NJ,M,19829,7267,27096,26.81945674638323
1931,NM,F,3882,619,4501,13.752499444567873
1931,NM,M,3708,840,4548,18.46965699208443
1931,NV,F,215,31,246,12.601626016260163
1931,NV,M,201,81,282,28.723404255319153
1931,NY,F,80712,9879,90591,10.905056793721231
1931,NY,M,68041,22126,90167,24.53891113156698
1931,OH,F,40579,6583,47162,13.958271489758703
1931,OH,M,38182,9789,47971,20.406078672531322
1931,OK,F,19516,2434,21950,11.088838268792712
1931,OK,M,18604,3047,21651,14.073252967530367
1931,OR,F,4586,471,5057,9.31382242436227
1931,OR,M,4547,872,5419,16.091529802546596
1931,PA,F,66578,10744,77322,13.895139804971418
1931,PA,M,56149,20321,76470,26.573819798613833
1931,RI,F,3981,498,4479,11.118553248492967
1931,RI,M,3437,1106,4543,24.345146379044685
1931,SC,F,15632,2822,18454,15.29207759835266
1931,SC,M,12064,4339,16403,26.452478205206365
1931,SD,F,4965,527,5492,9.59577567370721
1931,SD,M,4867,708,5575,12.699551569506726
1931,TN,F,22357,3908,26265,14.879116695221779
1931,TN,M,18938,5408,24346,22.213094553520087
1931,TX,F,50354,5836,56190,10.386189713472147
1931,TX,M,45799,9395,55194,17.02177772946335
1931,UT,F,3957,393,4350,9.034482758620689
1931,UT,M,4085,643,4728,13.599830795262266
1931,VA,F,19503,3090,22593,13.676802549462222
1931,VA,M,16574,4515,21089,21.40926549385936
1931,VT,F,2319,253,2572,9.836702954898911
1931,VT,M,2089,425,2514,16.905330151153542
1931,WA,F,7998,709,8707,8.142873550017228
1931,WA,M,7831,1424,9255,15.386277687736358
1931,WI,F,20716,2359,23075,10.223185265438786
1931,WI,M,19489,4069,23558,17.272264198998215
1931,WV,F,14717,2429,17146,14.166569462265253
1931,WV,M,13141,3058,16199,18.877708500524722
1931,WY,F,1308,184,1492,12.332439678284182
1931,WY,M,1278,278,1556,17.866323907455012
1932,AK,F,173,53,226,23.451327433628318
1932,AK,M,175,96,271,35.42435424354243
1932,AL,F,25680,4220,29900,14.11371237458194
1932,AL,M,21626,6150,27776,22.141417050691246
1932,AR,F,16398,2350,18748,12.534670364838915
1932,AR,M,14384,3338,17722,18.835345897754205
1932,AZ,F,3282,479,3761,12.735974474873704
1932,AZ,M,3280,700,3980,17.587939698492463
1932,CA,F,31157,3070,34227,8.969526981622696
1932,CA,M,29239,6047,35286,17.137108201553026
1932,CO,F,6949,917,7866,11.657767607424358
1932,CO,M,6788,1226,8014,15.298228100823557
1932,CT,F,8973,1066,10039,10.618587508716008
1932,CT,M,7377,2606,9983,26.104377441650804
1932,DC,F,3275,532,3807,13.974257945889152
1932,DC,M,2831,994,3825,25.986928104575163
1932,DE,F,1261,214,1475,14.508474576271185
1932,DE,M,1043,416,1459,28.51267991775189
1932,FL,F,10673,1588,12261,12.951635266291495
1932,FL,M,9373,2751,12124,22.690531177829097
1932,GA,F,26519,4225,30744,13.742518865469686
1932,GA,M,23027,6202,29229,21.218652707927056
1932,HI,F,3063,269,3332,8.073229291716686
1932,HI,M,2679,675,3354,20.125223613595708
1932,IA,F,15712,2068,17780,11.631046119235096
1932,IA,M,15552,2707,18259,14.82556547456049
1932,ID,F,2875,340,3215,10.57542768273717
1932,ID,M,2995,428,3423,12.503651767455448
1932,IL,F,44876,5634,50510,11.154226885765194
1932,IL,M,41503,10209,51712,19.7420327970297
1932,IN,F,19528,3242,22770,14.238032498902065
1932,IN,M,18846,4254,23100,18.415584415584416
1932,KS,F,11680,1516,13196,11.488329796908154
1932,KS,M,12166,1767,13933,12.682121581856027
1932,KY,F,23317,3994,27311,14.624144117754751
1932,KY,M,21097,5143,26240,19.599847560975608
1932,LA,F,18633,2358,20991,11.233385736744319
1932,LA,M,15294,4048,19342,20.928549271016443
1932,MA,F,26602,3314,29916,11.077684182377324
1932,MA,M,21761,8035,29796,26.96670694052893
1932,MD,F,10362,1788,12150,14.716049382716049
1932,MD,M,8720,2993,11713,25.552804576112013
1932,ME,F,5828,590,6418,9.192894982860704
1932,ME,M,5494,999,6493,15.385800092407209
1932,MI,F,32861,3832,36693,10.443408824571444
1932,MI,M,30982,6609,37591,17.58133595807507
1932,MN,F,17376,1979,19355,10.224748127098941
1932,MN,M,16495,3377,19872,16.99376006441224
1932,MO,F,24051,3601,27652,13.022566179661506
1932,MO,M,23195,4442,27637,16.072656221731737
1932,MS,F,19175,2841,22016,12.904251453488373
1932,MS,M,15546,4240,19786,21.429293439805924
1932,MT,F,3025,379,3404,11.133960047003526
1932,MT,M,2931,602,3533,17.03934333427682
1932,NC,F,31655,5020,36675,13.687798227675529
1932,NC,M,26283,7735,34018,22.737962255276617
1932,ND,F,5237,497,5734,8.667596791070805
1932,ND,M,5130,810,5940,13.636363636363635
1932,NE,F,9138,1046,10184,10.271013354281225
1932,NE,M,9619,1334,10953,12.179311604126724
1932,NH,F,2759,290,3049,9.511315185306659
1932,NH,M,2544,511,3055,16.72667757774141
1932,NJ,F,23670,2922,26592,10.98826714801444
1932,NJ,M,19594,6881,26475,25.990557129367325
1932,NM,F,4130,599,4729,12.66652569253542
1932,NM,M,3923,832,4755,17.497371188222925
1932,NV,F,246,50,296,16.89189189189189
1932,NV,M,215,69,284,24.295774647887324
1932,NY,F,78960,9125,88085,10.359312028154623
1932,NY,M,66296,22266,88562,25.141708633499693
1932,OH,F,39479,6218,45697,13.607020154495919
1932,OH,M,36596,9490,46086,20.591936813782926
1932,OK,F,19550,2399,21949,10.929882910383162
1932,OK,M,18703,3016,21719,13.886458860905199
1932,OR,F,4522,430,4952,8.683360258481422
1932,OR,M,4449,790,5239,15.079213590379844
1932,PA,F,64343,9872,74215,13.301893148285387
1932,PA,M,54287,19355,73642,26.282556150023083
1932,RI,F,3949,505,4454,11.33812303547373
1932,RI,M,3436,1124,4560,24.64912280701754
1932,SC,F,17766,3087,20853,14.803625377643503
1932,SC,M,13908,5012,18920,26.49048625792812
1932,SD,F,4824,540,5364,10.06711409395973
1932,SD,M,4755,700,5455,12.832263978001833
1932,TN,F,23215,3912,27127,14.421056511962252
1932,TN,M,20285,5288,25573,20.678058890235796
1932,TX,F,50429,5815,56244,10.338880591707559
1932,TX,M,46585,9610,56195,17.1011655841267
1932,UT,F,3890,417,4307,9.681913164615743
1932,UT,M,3999,628,4627,13.572509185217205
1932,VA,F,21316,3193,24509,13.0278673140479
1932,VA,M,17564,4903,22467,21.82311835135977
1932,VT,F,2149,237,2386,9.932942162615257
1932,VT,M,2018,413,2431,16.988893459481694
1932,WA,F,8009,781,8790,8.885096700796359
1932,WA,M,7700,1344,9044,14.860681114551083
1932,WI,F,20613,2389,23002,10.386053386662029
1932,WI,M,19059,4100,23159,17.70370050520316
1932,WV,F,15029,2517,17546,14.345149891713211
1932,WV,M,13680,3116,16796,18.552036199095024
1932,WY,F,1223,166,1389,11.95104391648668
1932,WY,M,1181,277,1458,18.998628257887518
1933,AK,F,198,57,255,22.35294117647059
1933,AK,M,180,93,273,34.065934065934066
1933,AL,F,23522,3883,27405,14.168947272395549
1933,AL,M,19949,5673,25622,22.14112871750839
1933,AR,F,16067,2257,18324,12.31717965509714
1933,AR,M,14107,3169,17276,18.343366520027786
1933,AZ,F,3037,425,3462,12.276140958983246
1933,AZ,M,2898,663,3561,18.618365627632688
1933,CA,F,29828,3059,32887,9.30154772402469
1933,CA,M,27957,6037,33994,17.759016296993586
1933,CO,F,6709,884,7593,11.64230212037403
1933,CO,M,6419,1271,7690,16.527958387516257
1933,CT,F,8248,1017,9265,10.976794387479764
1933,CT,M,7020,2428,9448,25.698560541913633
1933,DC,F,3142,503,3645,13.799725651577505
1933,DC,M,2735,1016,3751,27.08611037056785
1933,DE,F,1157,161,1318,12.215477996965099
1933,DE,M,1013,377,1390,27.12230215827338
1933,FL,F,9830,1384,11214,12.34171571250223
1933,FL,M,8514,2471,10985,22.494310423304505
1933,GA,F,24823,3943,28766,13.707154279357574
1933,GA,M,21271,5731,27002,21.224353751573958
1933,HI,F,2872,239,3111,7.682417229186757
1933,HI,M,2383,633,3016,20.988063660477454
1933,IA,F,15193,2025,17218,11.760947845278197
1933,IA,M,15388,2704,18092,14.945832412115854
1933,ID,F,2840,329,3169,10.38182391921742
1933,ID,M,2906,451,3357,13.434614238903784
1933,IL,F,42788,5332,48120,11.080631753948463
1933,IL,M,39443,9954,49397,20.151021317084034
1933,IN,F,18373,3076,21449,14.340994918178005
1933,IN,M,17577,4447,22024,20.191609153650564
1933,KS,F,11345,1490,12835,11.608881963381378
1933,KS,M,11402,1825,13227,13.797535344371362
1933,KY,F,22109,3875,25984,14.913023399014778
1933,KY,M,19872,4853,24725,19.627906976744185
1933,LA,F,17000,2077,19077,10.887456098967343
1933,LA,M,13861,3690,17551,21.02444305167797
1933,MA,F,24553,3027,27580,10.975344452501814
1933,MA,M,20249,7505,27754,27.04114722202205
1933,MD,F,9731,1682,11413,14.737579952685534
1933,MD,M,8243,2791,11034,25.294544136305962
1933,ME,F,5395,521,5916,8.806626098715348
1933,ME,M,5078,929,6007,15.465290494423172
1933,MI,F,31053,3704,34757,10.656846102943291
1933,MI,M,29079,6528,35607,18.3334737551605
1933,MN,F,16564,1759,18323,9.599956339027452
1933,MN,M,15960,3307,19267,17.164062905486063
1933,MO,F,23026,3193,26219,12.178191387924787
1933,MO,M,22203,4509,26712,16.880053908355794
1933,MS,F,17550,2754,20304,13.563829787234042
1933,MS,M,14775,3959,18734,21.13269990391801
1933,MT,F,2956,369,3325,11.097744360902254
1933,MT,M,2874,598,3472,17.223502304147466
1933,NC,F,29703,4715,34418,13.699227148585042
1933,NC,M,25771,7145,32916,21.706768744683437
1933,ND,F,4983,471,5454,8.635863586358635
1933,ND,M,4897,764,5661,13.495848789966436
1933,NE,F,8799,978,9777,10.003068425897514
1933,NE,M,8952,1273,10225,12.449877750611247
1933,NH,F,2563,259,2822,9.177888022678951
1933,NH,M,2375,523,2898,18.046928916494135
1933,NJ,F,21458,2657,24115,11.018038565208377
1933,NJ,M,17892,6621,24513,27.01015787541305
1933,NM,F,3901,571,4472,12.768336314847941
1933,NM,M,3769,829,4598,18.02957807742497
1933,NV,F,234,26,260,10.0
1933,NV,M,229,87,316,27.531645569620256
1933,NY,F,74216,8442,82658,10.213167509496964
1933,NY,M,62190,21269,83459,25.484369570687406
1933,OH,F,37170,5784,42954,13.46556781673418
1933,OH,M,33803,9282,43085,21.543460601137287
1933,OK,F,19479,2381,21860,10.892040256175664
1933,OK,M,18908,2966,21874,13.559477004663071
1933,OR,F,4225,437,4662,9.373659373659374
1933,OR,M,4304,790,5094,15.508441303494308
1933,PA,F,59572,9026,68598,13.157818012186945
1933,PA,M,50582,18505,69087,26.78506810253738
1933,RI,F,3768,401,4169,9.618613576397216
1933,RI,M,3110,1059,4169,25.40177500599664
1933,SC,F,17164,2944,20108,14.640938929779193
1933,SC,M,13362,4635,17997,25.754292382063674
1933,SD,F,4682,468,5150,9.087378640776699
1933,SD,M,4612,639,5251,12.169110645591315
1933,TN,F,22030,3609,25639,14.07621202074964
1933,TN,M,19183,5034,24217,20.78705041912706
1933,TX,F,48984,5504,54488,10.101306709734253
1933,TX,M,44468,9105,53573,16.995501465290353
1933,UT,F,3990,416,4406,9.4416704493872
1933,UT,M,3973,629,4602,13.667970447631465
1933,VA,F,19691,2931,22622,12.956414110158255
1933,VA,M,16741,4585,21326,21.4995779799306
1933,VT,F,2087,227,2314,9.809853068280034
1933,VT,M,1875,420,2295,18.30065359477124
1933,WA,F,7640,792,8432,9.392789373814042
1933,WA,M,7287,1419,8706,16.29910406616127
1933,WI,F,19266,2195,21461,10.227855179162201
1933,WI,M,18089,4182,22271,18.777782766826814
1933,WV,F,14158,2284,16442,13.891254105339984
1933,WV,M,12746,3125,15871,19.69000063008002
1933,WY,F,1180,156,1336,11.676646706586826
1933,WY,M,1208,274,1482,18.488529014844804
1934,AK,F,164,45,209,21.5311004784689
1934,AK,M,195,100,295,33.89830508474576
1934,AL,F,25172,4158,29330,14.176610978520287
1934,AL,M,21871,5949,27820,21.383896477354423
1934,AR,F,16410,2354,18764,12.545299509699426
1934,AR,M,14767,3311,18078,18.31507910167054
1934,AZ,F,3218,470,3688,12.744034707158352
1934,AZ,M,3162,636,3798,16.74565560821485
1934,CA,F,30997,3208,34205,9.378745797398041
1934,CA,M,29430,6155,35585,17.29661374174512
1934,CO,F,6973,926,7899,11.723002911760982
1934,CO,M,6759,1329,8088,16.431750741839764
1934,CT,F,8268,958,9226,10.383698244092782
1934,CT,M,7122,2470,9592,25.75062552126772
1934,DC,F,3501,454,3955,11.47914032869785
1934,DC,M,2800,984,3784,26.004228329809724
1934,DE,F,1197,186,1383,13.449023861171366
1934,DE,M,989,418,1407,29.708599857853592
1934,FL,F,10191,1482,11673,12.695965047545618
1934,FL,M,9030,2678,11708,22.873249060471473
1934,GA,F,26087,4190,30277,13.838887604452225
1934,GA,M,22725,6080,28805,21.107446623850027
1934,HI,F,2755,228,2983,7.643312101910828
1934,HI,M,2422,655,3077,21.286967825804354
1934,IA,F,16007,2076,18083,11.480395951999116
1934,IA,M,16035,2927,18962,15.436135428752241
1934,ID,F,3052,330,3382,9.757539917208751
1934,ID,M,3248,469,3717,12.617702448210924
1934,IL,F,44224,5223,49447,10.562824842760936
1934,IL,M,40551,10365,50916,20.357058684892763
1934,IN,F,19317,3103,22420,13.840321141837645
1934,IN,M,18306,4603,22909,20.092540049762103
1934,KS,F,11663,1512,13175,11.476280834914611
1934,KS,M,11873,1891,13764,13.73873873873874
1934,KY,F,23302,3984,27286,14.600894231474015
1934,KY,M,21332,5171,26503,19.51099875485794
1934,LA,F,18500,2234,20734,10.774573164850004
1934,LA,M,15016,3960,18976,20.868465430016865
1934,MA,F,24834,3035,27869,10.890236463454016
1934,MA,M,20630,7745,28375,27.295154185022025
1934,MD,F,9949,1551,11500,13.48695652173913
1934,MD,M,8428,2839,11267,25.19747936451584
1934,ME,F,5729,551,6280,8.773885350318471
1934,ME,M,5187,1077,6264,17.193486590038315
1934,MI,F,32715,3889,36604,10.624521910173751
1934,MI,M,30128,7191,37319,19.269005064444386
1934,MN,F,17158,1857,19015,9.765974230870365
1934,MN,M,16375,3555,19930,17.837431008529855
1934,MO,F,23781,3245,27026,12.006956264338045
1934,MO,M,22802,4669,27471,16.99610498343708
1934,MS,F,18568,2776,21344,13.005997001499251
1934,MS,M,15369,4224,19593,21.558719951002907
1934,MT,F,3172,388,3560,10.89887640449438
1934,MT,M,3215,680,3895,17.458279845956355
1934,NC,F,31708,4742,36450,13.009602194787382
1934,NC,M,26820,7717,34537,22.344152647884876
1934,ND,F,5110,530,5640,9.397163120567376
1934,ND,M,5136,773,5909,13.081739719072601
1934,NE,F,9178,1055,10233,10.309782077592104
1934,NE,M,9364,1398,10762,12.990150529641332
1934,NH,F,2685,257,2942,8.735554044867436
1934,NH,M,2520,552,3072,17.96875
1934,NJ,F,21142,2502,23644,10.581965826425309
1934,NJ,M,17401,6512,23913,27.232049512817298
1934,NM,F,4280,659,4939,13.342781939663901
1934,NM,M,3959,810,4769,16.984692807716502
1934,NV,F,252,34,286,11.888111888111888
1934,NV,M,327,93,420,22.142857142857142
1934,NY,F,74599,8146,82745,9.844703607468729
1934,NY,M,62154,21353,83507,25.57031147089466
1934,OH,F,39217,5742,44959,12.771636379812717
1934,OH,M,35777,10109,45886,22.03068474044371
1934,OK,F,20239,2337,22576,10.351700921332387
1934,OK,M,19551,3137,22688,13.826692524682652
1934,OR,F,4547,477,5024,9.494426751592357
1934,OR,M,4544,821,5365,15.302889095992544
1934,PA,F,62198,8888,71086,12.50316518020426
1934,PA,M,51677,19007,70684,26.890102427706413
1934,RI,F,3726,391,4117,9.497206703910614
1934,RI,M,3239,1019,4258,23.93142320338187
1934,SC,F,17790,2998,20788,14.421781797190686
1934,SC,M,14421,4906,19327,25.384177575412636
1934,SD,F,4685,500,5185,9.643201542912246
1934,SD,M,4633,727,5360,13.563432835820896
1934,TN,F,22942,3830,26772,14.305991334229793
1934,TN,M,20266,5313,25579,20.7709449157512
1934,TX,F,51425,5751,57176,10.058416118651182
1934,TX,M,48534,9727,58261,16.695559636806784
1934,UT,F,4006,402,4408,9.11978221415608
1934,UT,M,4067,672,4739,14.180206794682423
1934,VA,F,20010,2946,22956,12.833246210141139
1934,VA,M,17156,4720,21876,21.57615651855915
1934,VT,F,2137,239,2376,10.058922558922559
1934,VT,M,1922,399,2321,17.190866006031882
1934,WA,F,8290,848,9138,9.279929962792734
1934,WA,M,7970,1550,9520,16.281512605042018
1934,WI,F,19797,2356,22153,10.635128425044012
1934,WI,M,18657,4418,23075,19.14626218851571
1934,WV,F,15853,2449,18302,13.381051251229373
1934,WV,M,14442,3413,17855,19.11509381125735
1934,WY,F,1256,175,1431,12.22921034241789
1934,WY,M,1275,259,1534,16.883963494132985
1935,AK,F,163,50,213,23.474178403755868
1935,AK,M,150,84,234,35.8974358974359
1935,AL,F,25240,4029,29269,13.76541733574772
1935,AL,M,21509,6005,27514,21.825252598677036
1935,AR,F,16527,2407,18934,12.712580542938628
1935,AR,M,15024,3315,18339,18.076230983150662
1935,AZ,F,3404,482,3886,12.40349974266598
1935,AZ,M,3308,685,3993,17.15502128725269
1935,CA,F,31682,3234,34916,9.262229350441059
1935,CA,M,30266,6421,36687,17.502112464905824
1935,CO,F,7083,891,7974,11.173814898419865
1935,CO,M,6960,1394,8354,16.686617189370363
1935,CT,F,8479,969,9448,10.256138865368332
1935,CT,M,6975,2568,9543,26.909776799748506
1935,DC,F,3572,521,4093,12.72904959687271
1935,DC,M,3055,1161,4216,27.537950664136623
1935,DE,F,1229,201,1430,14.055944055944055
1935,DE,M,1044,389,1433,27.145847871598043
1935,FL,F,10957,1519,12476,12.175376723308753
1935,FL,M,9560,2817,12377,22.759957986588024
1935,GA,F,26279,3993,30272,13.190406976744187
1935,GA,M,22694,5928,28622,20.71134092655999
1935,HI,F,2764,252,3016,8.355437665782492
1935,HI,M,2399,645,3044,21.1892247043364
1935,IA,F,15946,2103,18049,11.651615047925093
1935,IA,M,15912,3055,18967,16.106922549691568
1935,ID,F,3187,334,3521,9.485941493893781
1935,ID,M,3336,456,3792,12.025316455696203
1935,IL,F,45180,5231,50411,10.376703497252583
1935,IL,M,41013,10931,51944,21.04381641768058
1935,IN,F,19651,3092,22743,13.595391988743788
1935,IN,M,18769,4771,23540,20.267629566694985
1935,KS,F,11470,1347,12817,10.50947959740969
1935,KS,M,11460,1936,13396,14.452075246342192
1935,KY,F,22731,3869,26600,14.545112781954886
1935,KY,M,21017,5162,26179,19.718094656022004
1935,LA,F,18363,2196,20559,10.681453378082592
1935,LA,M,15097,3950,19047,20.738173990654694
1935,MA,F,24719,2975,27694,10.742399075612045
1935,MA,M,20426,7723,28149,27.436143379871396
1935,MD,F,9979,1562,11541,13.53435577506282
1935,MD,M,8538,2937,11475,25.594771241830067
1935,ME,F,5728,575,6303,9.122640012692369
1935,ME,M,5198,1066,6264,17.017879948914434
1935,MI,F,34275,3716,37991,9.781263983575057
1935,MI,M,31415,7937,39352,20.169241715795895
1935,MN,F,17362,1971,19333,10.195003362126934
1935,MN,M,16164,3775,19939,18.93274487185917
1935,MO,F,23119,3225,26344,12.241876708168844
1935,MO,M,22088,4703,26791,17.55440259788735
1935,MS,F,19342,2716,22058,12.31299301840602
1935,MS,M,16093,4300,20393,21.085666650321187
1935,MT,F,3308,400,3708,10.787486515641856
1935,MT,M,3214,688,3902,17.631983598154793
1935,NC,F,31844,4737,36581,12.949345288537764
1935,NC,M,27684,7653,35337,21.65718651838017
1935,ND,F,5043,473,5516,8.57505438723713
1935,ND,M,4951,860,5811,14.799518155222854
1935,NE,F,8642,979,9621,10.175657416069015
1935,NE,M,8863,1310,10173,12.877224024378256
1935,NH,F,2828,292,3120,9.35897435897436
1935,NH,M,2414,616,3030,20.33003300330033
1935,NJ,F,21011,2461,23472,10.484832992501705
1935,NJ,M,17936,6526,24462,26.67811299157877
1935,NM,F,4422,728,5150,14.135922330097086
1935,NM,M,4047,827,4874,16.967583093967995
1935,NV,F,253,43,296,14.527027027027026
1935,NV,M,308,87,395,22.025316455696203
1935,NY,F,74501,8288,82789,10.010991798427327
1935,NY,M,61864,22122,83986,26.340104303098133
1935,OH,F,40043,5720,45763,12.499180560714988
1935,OH,M,36271,10396,46667,22.27698373583046
1935,OK,F,19644,2323,21967,10.57495333909956
1935,OK,M,18679,3101,21780,14.23783287419651
1935,OR,F,4573,490,5063,9.678056488248075
1935,OR,M,4640,906,5546,16.336098088712586
1935,PA,F,62945,8607,71552,12.029013864042934
1935,PA,M,52687,19519,72206,27.032379580644267
1935,RI,F,3748,398,4146,9.599614085865895
1935,RI,M,3223,1003,4226,23.73402744912447
1935,SC,F,17578,2911,20489,14.207623602908878
1935,SC,M,14036,4902,18938,25.88446509663111
1935,SD,F,4503,498,5001,9.958008398320336
1935,SD,M,4672,712,5384,13.224368499257059
1935,TN,F,23567,3769,27336,13.7876792508048
1935,TN,M,20825,5357,26182,20.46062180123749
1935,TX,F,51057,5681,56738,10.012689907998167
1935,TX,M,47551,9447,56998,16.574265763711008
1935,UT,F,4202,445,4647,9.576070583171939
1935,UT,M,4229,754,4983,15.13144691952639
1935,VA,F,20027,2848,22875,12.450273224043716
1935,VA,M,17116,4768,21884,21.787607384390423
1935,VT,F,2284,242,2526,9.58036421219319
1935,VT,M,2001,455,2456,18.526058631921824
1935,WA,F,8097,876,8973,9.762621196924105
1935,WA,M,8042,1646,9688,16.99009083402147
1935,WI,F,20260,2377,22637,10.500508017846888
1935,WI,M,18743,4850,23593,20.55694485652524
1935,WV,F,16069,2349,18418,12.753827777174504
1935,WV,M,14389,3539,17928,19.740071396697903
1935,WY,F,1269,173,1442,11.997226074895979
1935,WY,M,1297,283,1580,17.911392405063292
1936,AK,F,208,62,270,22.962962962962962
1936,AK,M,238,115,353,32.577903682719544
1936,AL,F,24613,3735,28348,13.17553266544377
1936,AL,M,21062,5781,26843,21.536340945497894
1936,AR,F,15240,2064,17304,11.927877947295423
1936,AR,M,13781,3126,16907,18.489383095759155
1936,AZ,F,3456,532,3988,13.34002006018054
1936,AZ,M,3440,731,4171,17.525773195876287
1936,CA,F,33344,3460,36804,9.40115204869036
1936,CA,M,30964,7143,38107,18.744587608575852
1936,CO,F,7021,894,7915,11.295009475679091
1936,CO,M,6942,1430,8372,17.080745341614907
1936,CT,F,8306,927,9233,10.04007364886819
1936,CT,M,6977,2746,9723,28.242312043607942
1936,DC,F,3917,518,4435,11.679819616685457
1936,DC,M,3263,1245,4508,27.617568766637092
1936,DE,F,1148,170,1318,12.898330804248861
1936,DE,M,980,434,1414,30.693069306930692
1936,FL,F,11070,1515,12585,12.038140643623361
1936,FL,M,9746,2775,12521,22.162766552192316
1936,GA,F,25639,3737,29376,12.721269063180829
1936,GA,M,22532,6056,28588,21.183713446201203
1936,HI,F,2597,222,2819,7.875133025895707
1936,HI,M,2170,610,2780,21.942446043165468
1936,IA,F,16305,2273,18578,12.234901496393585
1936,IA,M,16318,3104,19422,15.981876222840077
1936,ID,F,3368,398,3766,10.568242166755178
1936,ID,M,3449,602,4051,14.86052826462602
1936,IL,F,45071,5476,50547,10.833481710091599
1936,IL,M,41269,11071,52340,21.1520825372564
1936,IN,F,20069,3118,23187,13.447190235908051
1936,IN,M,18936,4993,23929,20.86589493919512
1936,KS,F,11018,1421,12439,11.423747889701746
1936,KS,M,11595,1876,13471,13.926211862519486
1936,KY,F,22146,3569,25715,13.879058915030138
1936,KY,M,20333,4966,25299,19.629234357089214
1936,LA,F,18311,2161,20472,10.555881203595154
1936,LA,M,15435,4125,19560,21.088957055214724
1936,MA,F,24317,2920,27237,10.7207107978118
1936,MA,M,19896,7984,27880,28.637015781922525
1936,MD,F,9573,1537,11110,13.834383438343833
1936,MD,M,8436,2850,11286,25.252525252525253
1936,ME,F,5608,573,6181,9.270344604432939
1936,ME,M,5081,1148,6229,18.42992454647616
1936,MI,F,34572,4184,38756,10.795747755186294
1936,MI,M,31676,8160,39836,20.483984335776682
1936,MN,F,17809,2065,19874,10.390459897353326
1936,MN,M,16836,3973,20809,19.092700273919938
1936,MO,F,22679,3143,25822,12.171791495623886
1936,MO,M,21450,4749,26199,18.126646055192946
1936,MS,F,18555,2718,21273,12.77675927231702
1936,MS,M,15613,4172,19785,21.08668182966894
1936,MT,F,3533,363,3896,9.317248459958932
1936,MT,M,3298,763,4061,18.78847574489042
1936,NC,F,31265,4364,35629,12.248449296921047
1936,NC,M,26618,7445,34063,21.856559903707836
1936,ND,F,5058,534,5592,9.549356223175966
1936,ND,M,4799,860,5659,15.197031277610884
1936,NE,F,8733,1040,9773,10.641563491251407
1936,NE,M,8978,1358,10336,13.138544891640866
1936,NH,F,2678,233,2911,8.004122294744075
1936,NH,M,2419,657,3076,21.35890767230169
1936,NJ,F,21224,2281,23505,9.704318230163794
1936,NJ,M,17407,6646,24053,27.630648983494783
1936,NM,F,4198,658,4856,13.550247116968697
1936,NM,M,4235,910,5145,17.687074829931973
1936,NV,F,193,42,235,17.872340425531917
1936,NV,M,286,95,381,24.93438320209974
1936,NY,F,73889,7999,81888,9.768220007815554
1936,NY,M,61377,22593,83970,26.906037870668097
1936,OH,F,41140,5753,46893,12.268355618109313
1936,OH,M,36674,10919,47593,22.94244951988738
1936,OK,F,17850,2111,19961,10.575622463804418
1936,OK,M,18166,3037,21203,14.323444795547799
1936,OR,F,4860,557,5417,10.28244415728263
1936,OR,M,5029,995,6024,16.51726427622842
1936,PA,F,62653,8389,71042,11.808507643365896
1936,PA,M,52079,19520,71599,27.262950599868713
1936,RI,F,3724,394,4118,9.567751335599805
1936,RI,M,3123,1066,4189,25.44760085939365
1936,SC,F,17197,2756,19953,13.812459279306369
1936,SC,M,13934,4606,18540,24.843581445523196
1936,SD,F,4610,497,5107,9.731740747992951
1936,SD,M,4540,765,5305,14.420358152686145
1936,TN,F,22877,3522,26399,13.341414447516954
1936,TN,M,20342,5182,25524,20.30246042939978
1936,TX,F,49357,5514,54871,10.04902407464781
1936,TX,M,46337,9390,55727,16.850000897231148
1936,UT,F,4089,472,4561,10.34860776145582
1936,UT,M,4073,770,4843,15.899236010737146
1936,VA,F,20009,2724,22733,11.982580389741786
1936,VA,M,17183,4654,21837,21.31245134404909
1936,VT,F,2180,252,2432,10.361842105263158
1936,VT,M,1955,497,2452,20.26916802610114
1936,WA,F,8507,911,9418,9.672966659588022
1936,WA,M,8298,1843,10141,18.173750123262007
1936,WI,F,20233,2494,22727,10.973731684780217
1936,WI,M,18634,4993,23627,21.132602531002668
1936,WV,F,16048,2315,18363,12.606872515384197
1936,WV,M,14299,3663,17962,20.393051998663847
1936,WY,F,1349,184,1533,12.002609262883235
1936,WY,M,1379,282,1661,16.977724262492476
1937,AK,F,206,62,268,23.134328358208954
1937,AK,M,218,97,315,30.793650793650794
1937,AL,F,24933,3944,28877,13.657928455171936
1937,AL,M,21709,5975,27684,21.582863748013292
1937,AR,F,15509,2175,17684,12.299253562542411
1937,AR,M,14376,3172,17548,18.07613403236836
1937,AZ,F,3957,576,4533,12.706816677696889
1937,AZ,M,3756,771,4527,17.0311464546057
1937,CA,F,36669,3916,40585,9.648885056055192
1937,CA,M,34953,8184,43137,18.97211210793518
1937,CO,F,7433,1034,8467,12.212117633164048
1937,CO,M,7390,1616,9006,17.94359316011548
1937,CT,F,8465,951,9416,10.09983007646559
1937,CT,M,7082,2840,9922,28.62326143922596
1937,DC,F,4211,578,4789,12.06932553769054
1937,DC,M,3482,1435,4917,29.184462070368113
1937,DE,F,1264,174,1438,12.100139082058414
1937,DE,M,1187,468,1655,28.27794561933535
1937,FL,F,11393,1594,12987,12.273812273812274
1937,FL,M,9868,2955,12823,23.044529361303905
1937,GA,F,26339,3983,30322,13.135677066156587
1937,GA,M,22823,6292,29115,21.610853511935428
1937,HI,F,2802,213,3015,7.064676616915423
1937,HI,M,2405,679,3084,22.01686121919585
1937,IA,F,16017,2229,18246,12.216376192042091
1937,IA,M,16058,3285,19343,16.982887866411623
1937,ID,F,3439,392,3831,10.232315322370138
1937,ID,M,3644,551,4195,13.134684147794996
1937,IL,F,46011,5911,51922,11.384384268710757
1937,IL,M,42061,12004,54065,22.202903911957826
1937,IN,F,20578,3416,23994,14.236892556472453
1937,IN,M,20007,5379,25386,21.18884424485937
1937,KS,F,10576,1499,12075,12.41407867494824
1937,KS,M,11124,1919,13043,14.712872805336197
1937,KY,F,22573,3568,26141,13.649057036838682
1937,KY,M,20520,5191,25711,20.189802030259422
1937,LA,F,19090,2305,21395,10.773545220845993
1937,LA,M,15956,4230,20186,20.955117408104627
1937,MA,F,24329,2954,27283,10.827255067258
1937,MA,M,20023,8314,28337,29.339732505205205
1937,MD,F,10263,1623,11886,13.65471983846542
1937,MD,M,8673,3045,11718,25.985663082437277
1937,ME,F,5482,625,6107,10.234157524152613
1937,ME,M,5083,1101,6184,17.804010349288486
1937,MI,F,35510,4360,39870,10.935540506646602
1937,MI,M,32832,8955,41787,21.430109842774065
1937,MN,F,18169,2117,20286,10.435768510302672
1937,MN,M,16852,4334,21186,20.456905503634477
1937,MO,F,22671,3258,25929,12.56508156889969
1937,MO,M,21669,4901,26570,18.445615355664284
1937,MS,F,19454,2682,22136,12.11601011926274
1937,MS,M,16291,4412,20703,21.310921122542624
1937,MT,F,3425,411,3836,10.714285714285714
1937,MT,M,3426,747,4173,17.90079079798706
1937,NC,F,31984,4527,36511,12.399003040179672
1937,NC,M,27232,7828,35060,22.32743867655448
1937,ND,F,4464,468,4932,9.48905109489051
1937,ND,M,4616,796,5412,14.708056171470806
1937,NE,F,8016,1068,9084,11.756935270805812
1937,NE,M,8435,1323,9758,13.558106169296988
1937,NH,F,2688,298,2986,9.979906229068987
1937,NH,M,2372,659,3031,21.741999340151764
1937,NJ,F,21497,2479,23976,10.339506172839506
1937,NJ,M,17780,6813,24593,27.703004920099218
1937,NM,F,4632,733,5365,13.662628145386766
1937,NM,M,4560,949,5509,17.226356870575422
1937,NV,F,335,44,379,11.609498680738787
1937,NV,M,394,122,516,23.643410852713178
1937,NY,F,75271,8254,83525,9.88207123615684
1937,NY,M,61855,23793,85648,27.779983186997946
1937,OH,F,42489,6035,48524,12.437144505811556
1937,OH,M,38106,11893,49999,23.78647572951459
1937,OK,F,17340,2147,19487,11.01760147790835
1937,OK,M,16999,3025,20024,15.106871753895327
1937,OR,F,5308,711,6019,11.812593454062137
1937,OR,M,5376,1175,6551,17.936192947641583
1937,PA,F,62954,8618,71572,12.041021628569831
1937,PA,M,53456,20129,73585,27.35475980159
1937,RI,F,3790,357,4147,8.608632746563782
1937,RI,M,3189,1123,4312,26.04359925788497
1937,SC,F,17615,3006,20621,14.57737258134911
1937,SC,M,14279,4945,19224,25.723054515189347
1937,SD,F,4143,484,4627,10.460341473957207
1937,SD,M,4061,691,4752,14.54124579124579
1937,TN,F,23150,3359,26509,12.671168282470106
1937,TN,M,20484,5332,25816,20.65385807251317
1937,TX,F,50212,5654,55866,10.120645831095837
1937,TX,M,47239,9579,56818,16.859093949100636
1937,UT,F,4093,438,4531,9.666740233943942
1937,UT,M,4253,861,5114,16.836136096988657
1937,VA,F,20254,2813,23067,12.19491047817228
1937,VA,M,17296,4812,22108,21.765876605753572
1937,VT,F,2132,232,2364,9.813874788494077
1937,VT,M,1887,526,2413,21.798590965602983
1937,WA,F,9285,1033,10318,10.011630160883893
1937,WA,M,8846,2055,10901,18.851481515457298
1937,WI,F,20326,2784,23110,12.046733016010384
1937,WI,M,18657,5348,24005,22.27869193917934
1937,WV,F,16640,2405,19045,12.627986348122866
1937,WV,M,14805,3740,18545,20.167160959827445
1937,WY,F,1217,246,1463,16.814764183185236
1937,WY,M,1353,313,1666,18.7875150060024
1938,AK,F,231,50,281,17.793594306049823
1938,AK,M,265,98,363,26.997245179063363
1938,AL,F,25202,4120,29322,14.050883295818839
1938,AL,M,21516,5999,27515,21.802653098310014
1938,AR,F,16479,2223,18702,11.88642925890279
1938,AR,M,14796,3414,18210,18.74794069192751
1938,AZ,F,4090,596,4686,12.718736662398634
1938,AZ,M,4052,847,4899,17.289242702592368
1938,CA,F,39950,4551,44501,10.22673647783196
1938,CA,M,38014,9088,47102,19.29429748206021
1938,CO,F,7859,1027,8886,11.557506189511592
1938,CO,M,7590,1756,9346,18.788786646693772
1938,CT,F,8840,1019,9859,10.335733847246171
1938,CT,M,7334,3109,10443,29.771138561715983
1938,DC,F,4400,596,4996,11.929543634907928
1938,DC,M,3771,1517,5288,28.687594553706507
1938,DE,F,1322,194,1516,12.796833773087071
1938,DE,M,1204,464,1668,27.81774580335731
1938,FL,F,11933,1638,13571,12.069854837521184
1938,FL,M,10665,3154,13819,22.823648599753962
1938,GA,F,26595,4198,30793,13.632968531809178
1938,GA,M,23242,6346,29588,21.44788427740976
1938,HI,F,2795,228,3023,7.542176645716175
1938,HI,M,2568,701,3269,21.443866625879473
1938,IA,F,16380,2529,18909,13.374583531651593
1938,IA,M,16605,3435,20040,17.14071856287425
1938,ID,F,3683,493,4176,11.805555555555555
1938,ID,M,3878,678,4556,14.881474978050921
1938,IL,F,48629,6571,55200,11.903985507246377
1938,IL,M,44260,12778,57038,22.40260878712437
1938,IN,F,22146,3913,26059,15.015925400053723
1938,IN,M,21024,5964,26988,22.098710538016896
1938,KS,F,10640,1654,12294,13.453717260452253
1938,KS,M,11228,2010,13238,15.183562471672458
1938,KY,F,24409,3815,28224,13.516865079365079
1938,KY,M,22417,5547,27964,19.83621799456444
1938,LA,F,19806,2411,22217,10.852050231804473
1938,LA,M,16959,4443,21402,20.75974208017942
1938,MA,F,24996,3086,28082,10.989245780215084
1938,MA,M,20086,8671,28757,30.152658483151928
1938,MD,F,10741,1696,12437,13.63672911473828
1938,MD,M,9314,3146,12460,25.248796147672554
1938,ME,F,5635,608,6243,9.738907576485664
1938,ME,M,4981,1232,6213,19.8293899887333
1938,MI,F,36964,5297,42261,12.534014812711483
1938,MI,M,34583,9712,44295,21.925725251157015
1938,MN,F,18412,2585,20997,12.311282564175835
1938,MN,M,17698,4772,22470,21.23720516243881
1938,MO,F,23365,3467,26832,12.921138938580798
1938,MO,M,22700,5094,27794,18.3276966251709
1938,MS,F,19747,2797,22544,12.406848828956708
1938,MS,M,16852,4604,21456,21.45786726323639
1938,MT,F,3461,442,3903,11.3246220855752
1938,MT,M,3590,775,4365,17.75486827033219
1938,NC,F,32087,4870,36957,13.17747652677436
1938,NC,M,27806,7915,35721,22.157834327146496
1938,ND,F,4701,569,5270,10.79696394686907
1938,ND,M,4438,854,5292,16.137566137566136
1938,NE,F,7846,1186,9032,13.131089459698849
1938,NE,M,8552,1447,9999,14.471447144714473
1938,NH,F,2768,309,3077,10.042248943776405
1938,NH,M,2363,729,3092,23.576972833117722
1938,NJ,F,22212,2496,24708,10.10199125789218
1938,NJ,M,18331,7139,25470,28.0290537887711
1938,NM,F,4803,739,5542,13.334536268495128
1938,NM,M,4662,1018,5680,17.922535211267608
1938,NV,F,344,62,406,15.270935960591133
1938,NV,M,421,157,578,27.162629757785467
1938,NY,F,77060,8477,85537,9.910331201702187
1938,NY,M,63233,25010,88243,28.342191448613484
1938,OH,F,44573,6498,51071,12.723463413678996
1938,OH,M,40095,12606,52701,23.919849718221666
1938,OK,F,18064,2259,20323,11.115484918565173
1938,OK,M,17894,3185,21079,15.10982494425732
1938,OR,F,5521,739,6260,11.805111821086262
1938,OR,M,5802,1222,7024,17.39749430523918
1938,PA,F,65307,9045,74352,12.1651065203357
1938,PA,M,54841,21348,76189,28.019792883487117
1938,RI,F,3900,406,4306,9.428704133766837
1938,RI,M,3243,1219,4462,27.31958762886598
1938,SC,F,17546,2941,20487,14.355444916288379
1938,SC,M,14397,5005,19402,25.796309658798062
1938,SD,F,4071,516,4587,11.249182472204055
1938,SD,M,4131,739,4870,15.17453798767967
1938,TN,F,23570,3548,27118,13.083560734567445
1938,TN,M,21231,5592,26823,20.847779890392573
1938,TX,F,51615,6081,57696,10.539725457570716
1938,TX,M,48737,10442,59179,17.644772638942868
1938,UT,F,4279,504,4783,10.537319673844866
1938,UT,M,4312,961,5273,18.22491940072065
1938,VA,F,21050,2787,23837,11.69190753870034
1938,VA,M,18066,5237,23303,22.473501265931425
1938,VT,F,2120,233,2353,9.902252443688909
1938,VT,M,1910,563,2473,22.765871411241406
1938,WA,F,9725,1220,10945,11.146642302421197
1938,WA,M,9491,2266,11757,19.273624223866634
1938,WI,F,20753,3120,23873,13.069157625769698
1938,WI,M,19156,5637,24793,22.736256201347153
1938,WV,F,16600,2445,19045,12.838015227093724
1938,WV,M,15258,3910,19168,20.398580968280466
1938,WY,F,1337,241,1578,15.272496831432193
1938,WY,M,1472,343,1815,18.898071625344354
1939,AK,F,208,69,277,24.90974729241877
1939,AK,M,206,131,337,38.87240356083086
1939,AL,F,24379,3956,28335,13.961531674607375
1939,AL,M,21849,6095,27944,21.811480103063268
1939,AR,F,15998,2196,18194,12.069913158184017
1939,AR,M,14674,3436,18110,18.97294312534511
1939,AZ,F,3966,639,4605,13.876221498371336
1939,AZ,M,3912,883,4795,18.415015641293014
1939,CA,F,40790,4831,45621,10.589421538326647
1939,CA,M,38053,9792,47845,20.466088410492215
1939,CO,F,7657,1136,8793,12.919367678835435
1939,CO,M,7651,1788,9439,18.942684606420173
1939,CT,F,8684,1171,9855,11.882293252156266
1939,CT,M,7408,3031,10439,29.035348213430407
1939,DC,F,4890,707,5597,12.63176701804538
1939,DC,M,3998,1735,5733,30.26338740624455
1939,DE,F,1332,219,1551,14.119922630560927
1939,DE,M,1134,517,1651,31.31435493640218
1939,FL,F,12012,1813,13825,13.11392405063291
1939,FL,M,11068,3299,14367,22.962344261154033
1939,GA,F,26840,4278,31118,13.747670158750564
1939,GA,M,24078,6478,30556,21.200418902997775
1939,HI,F,2969,297,3266,9.093692590324556
1939,HI,M,2699,775,3474,22.30857800805987
1939,IA,F,16389,2682,19071,14.063237376120814
1939,IA,M,16599,3626,20225,17.928306551297897
1939,ID,F,3598,500,4098,12.201073694485116
1939,ID,M,3890,712,4602,15.471534115601912
1939,IL,F,46521,7190,53711,13.386457150304407
1939,IL,M,42415,12855,55270,23.258548941559617
1939,IN,F,21273,4121,25394,16.22824289202174
1939,IN,M,20232,6243,26475,23.580736543909346
1939,KS,F,10496,1799,12295,14.631964213094752
1939,KS,M,11049,2127,13176,16.14298724954463
1939,KY,F,23712,3854,27566,13.980991075963143
1939,KY,M,21648,5670,27318,20.755545793981987
1939,LA,F,19971,2617,22588,11.585797768726758
1939,LA,M,17002,4671,21673,21.55216167581784
1939,MA,F,24882,3339,28221,11.831614754969703
1939,MA,M,19813,9121,28934,31.523467201216558
1939,MD,F,10399,1621,12020,13.48585690515807
1939,MD,M,9210,3257,12467,26.124969920590356
1939,ME,F,5411,679,6090,11.149425287356323
1939,ME,M,4916,1311,6227,21.053476794604144
1939,MI,F,35708,5778,41486,13.927590030371691
1939,MI,M,33623,9948,43571,22.831699983934268
1939,MN,F,18424,2838,21262,13.347756561000846
1939,MN,M,17543,5043,22586,22.327990790755337
1939,MO,F,23131,3683,26814,13.735362124263444
1939,MO,M,22488,5441,27929,19.481542482724052
1939,MS,F,19218,2820,22038,12.7960794990471
1939,MS,M,16551,4548,21099,21.555523958481444
1939,MT,F,3626,519,4145,12.521109770808202
1939,MT,M,3623,885,4508,19.63176574977817
1939,NC,F,32142,4696,36838,12.747706172973562
1939,NC,M,27992,8201,36193,22.659077722211478
1939,ND,F,4604,576,5180,11.119691119691119
1939,ND,M,4629,882,5511,16.004354926510615
1939,NE,F,7821,1252,9073,13.799184393254713
1939,NE,M,8522,1537,10059,15.279848891539915
1939,NH,F,2696,342,3038,11.257406188281765
1939,NH,M,2546,774,3320,23.313253012048193
1939,NJ,F,22240,2693,24933,10.800946536718406
1939,NJ,M,18441,7244,25685,28.203231458049444
1939,NM,F,4748,808,5556,14.542836573074155
1939,NM,M,4577,943,5520,17.083333333333332
1939,NV,F,399,58,457,12.691466083150985
1939,NV,M,415,160,575,27.82608695652174
1939,NY,F,76313,8879,85192,10.422340125833411
1939,NY,M,62289,25559,87848,29.094572443311172
1939,OH,F,43614,6783,50397,13.45913447229002
1939,OH,M,38685,12856,51541,24.94324906385208
1939,OK,F,17675,2343,20018,11.704465980617444
1939,OK,M,17690,3161,20851,15.159944367176633
1939,OR,F,5754,820,6574,12.473379981746273
1939,OR,M,5952,1392,7344,18.954248366013072
1939,PA,F,63091,9182,72273,12.704606146140328
1939,PA,M,53042,20847,73889,28.213942535424756
1939,RI,F,3790,434,4224,10.274621212121213
1939,RI,M,3198,1318,4516,29.185119574844997
1939,SC,F,18198,2951,21149,13.95337841032673
1939,SC,M,15038,5362,20400,26.284313725490193
1939,SD,F,4128,584,4712,12.39388794567063
1939,SD,M,4138,752,4890,15.378323108384459
1939,TN,F,23534,3611,27145,13.302634002578746
1939,TN,M,21228,5839,27067,21.57239442864004
1939,TX,F,50814,6168,56982,10.824470885542803
1939,TX,M,48314,10568,58882,17.947759926632926
1939,UT,F,4180,576,4756,12.111017661900757
1939,UT,M,4335,953,5288,18.02193645990923
1939,VA,F,20928,2892,23820,12.141057934508815
1939,VA,M,18058,5079,23137,21.951852011928946
1939,VT,F,2106,252,2358,10.687022900763358
1939,VT,M,1911,582,2493,23.345367027677497
1939,WA,F,9529,1274,10803,11.793020457280386
1939,WA,M,9317,2333,11650,20.025751072961373
1939,WI,F,20013,3486,23499,14.83467381590706
1939,WI,M,18737,5982,24719,24.20000809094219
1939,WV,F,16320,2444,18764,13.024941377105096
1939,WV,M,14998,3963,18961,20.900796371499393
1939,WY,F,1333,228,1561,14.606021780909673
1939,WY,M,1524,345,1869,18.45906902086677
1940,AK,F,287,82,369,22.22222222222222
1940,AK,M,281,156,437,35.6979405034325
1940,AL,F,25529,3992,29521,13.52257714847058
1940,AL,M,22463,6356,28819,22.054894340539228
1940,AR,F,16809,2306,19115,12.063824221815327
1940,AR,M,15574,3673,19247,19.083493531459446
1940,AZ,F,4177,672,4849,13.858527531449782
1940,AZ,M,4072,946,5018,18.852132323634915
1940,CA,F,44292,5623,49915,11.265150756285685
1940,CA,M,41407,11290,52697,21.424369508700686
1940,CO,F,7853,1229,9082,13.532261616384055
1940,CO,M,7894,1922,9816,19.580277098614506
1940,CT,F,9318,1329,10647,12.482389405466328
1940,CT,M,7734,3382,11116,30.424613170205113
1940,DC,F,5343,789,6132,12.86692759295499
1940,DC,M,4443,1893,6336,29.876893939393938
1940,DE,F,1389,205,1594,12.86072772898369
1940,DE,M,1284,541,1825,29.64383561643836
1940,FL,F,12975,1838,14813,12.40801998244785
1940,FL,M,11792,3692,15484,23.84396796693361
1940,GA,F,27477,4259,31736,13.420090748676582
1940,GA,M,24374,6787,31161,21.7804306665383
1940,HI,F,3109,266,3375,7.881481481481481
1940,HI,M,2808,785,3593,21.84803785137768
1940,IA,F,16634,3085,19719,15.644809574522034
1940,IA,M,17004,4027,21031,19.147924492415957
1940,ID,F,3695,575,4270,13.466042154566745
1940,ID,M,4105,741,4846,15.290961617829138
1940,IL,F,48147,8109,56256,14.414462457337883
1940,IL,M,44665,14247,58912,24.183527973927212
1940,IN,F,22395,4470,26865,16.638749302065886
1940,IN,M,21449,6975,28424,24.53912186884323
1940,KS,F,10465,1837,12302,14.93253129572427
1940,KS,M,10818,2126,12944,16.42459826946848
1940,KY,F,24443,4203,28646,14.672205543531383
1940,KY,M,22653,5901,28554,20.666106324858163
1940,LA,F,20766,2648,23414,11.309472964892798
1940,LA,M,17890,4728,22618,20.9037050137059
1940,MA,F,25673,3711,29384,12.629322080043561
1940,MA,M,20914,9791,30705,31.887314769581504
1940,MD,F,11199,1792,12991,13.794165191286275
1940,MD,M,9978,3492,13470,25.92427616926503
1940,ME,F,5443,707,6150,11.495934959349594
1940,ME,M,4979,1408,6387,22.044778456239236
1940,MI,F,37366,6353,43719,14.531439419931838
1940,MI,M,34859,11162,46021,24.25414484691771
1940,MN,F,19347,3354,22701,14.774679529536144
1940,MN,M,18398,5528,23926,23.104572431664298
1940,MO,F,23949,4011,27960,14.34549356223176
1940,MO,M,23343,5841,29184,20.01439144736842
1940,MS,F,19732,2871,22603,12.701853736229705
1940,MS,M,17035,4787,21822,21.936577765557693
1940,MT,F,3627,654,4281,15.276804484933425
1940,MT,M,3739,976,4715,20.69989395546129
1940,NC,F,32813,4839,37652,12.85190693721449
1940,NC,M,28554,8444,36998,22.822855289475108
1940,ND,F,4600,719,5319,13.517578492197782
1940,ND,M,4612,968,5580,17.34767025089606
1940,NE,F,7927,1323,9250,14.302702702702701
1940,NE,M,8178,1532,9710,15.777548918640576
1940,NH,F,2944,380,3324,11.432009626955475
1940,NH,M,2658,841,3499,24.035438696770505
1940,NJ,F,22861,2972,25833,11.504664576317115
1940,NJ,M,19112,8057,27169,29.655121645993592
1940,NM,F,5037,830,5867,14.146923470257372
1940,NM,M,4954,1005,5959,16.86524584661856
1940,NV,F,438,88,526,16.730038022813687
1940,NV,M,476,153,629,24.324324324324326
1940,NY,F,80017,9683,89700,10.794871794871796
1940,NY,M,65904,27849,93753,29.704649451217563
1940,OH,F,45289,7408,52697,14.057726246275879
1940,OH,M,40295,13865,54160,25.60007385524372
1940,OK,F,17786,2375,20161,11.780169634442736
1940,OK,M,17958,3351,21309,15.725749683232436
1940,OR,F,6207,928,7135,13.006306937631395
1940,OR,M,6337,1567,7904,19.825404858299596
1940,PA,F,65177,9813,74990,13.085744765968796
1940,PA,M,54777,22040,76817,28.691565669057628
1940,RI,F,4071,461,4532,10.172109443954104
1940,RI,M,3343,1255,4598,27.294475859069163
1940,SC,F,18771,3119,21890,14.248515303791686
1940,SC,M,15599,5619,21218,26.482232067112825
1940,SD,F,4117,600,4717,12.71994912020352
1940,SD,M,4225,826,5051,16.353197386656106
1940,TN,F,24445,3715,28160,13.192471590909092
1940,TN,M,21949,5957,27906,21.346663799899662
1940,TX,F,53599,6493,60092,10.805098848432404
1940,TX,M,50701,11537,62238,18.53690671294065
1940,UT,F,4471,535,5006,10.68717538953256
1940,UT,M,4441,1094,5535,19.765130984643182
1940,VA,F,21696,3026,24722,12.240110023460884
1940,VA,M,19010,5442,24452,22.255848192376902
1940,VT,F,2219,298,2517,11.839491458085021
1940,VT,M,1918,628,2546,24.666142969363708
1940,WA,F,9997,1559,11556,13.490827275874004
1940,WA,M,9911,2636,12547,21.009006136925162
1940,WI,F,20162,4019,24181,16.620487159339977
1940,WI,M,18700,6428,25128,25.581025151225724
1940,WV,F,16319,2614,18933,13.80658110177996
1940,WV,M,15216,4156,19372,21.453644435267396
1940,WY,F,1404,252,1656,15.217391304347828
1940,WY,M,1504,360,1864,19.313304721030043
1941,AK,F,295,102,397,25.692695214105793
1941,AK,M,351,166,517,32.10831721470019
1941,AL,F,25780,3943,29723,13.265821081317497
1941,AL,M,22980,6459,29439,21.94028329766636
1941,AR,F,17214,2436,19650,12.396946564885496
1941,AR,M,15989,3784,19773,19.137207302887777
1941,AZ,F,4389,675,5064,13.329383886255924
1941,AZ,M,4194,971,5165,18.799612778315584
1941,CA,F,49484,6237,55721,11.19326645250444
1941,CA,M,45725,12839,58564,21.923024383580355
1941,CO,F,7836,1272,9108,13.965744400527008
1941,CO,M,7679,2074,9753,21.26525171742028
1941,CT,F,10760,1479,12239,12.084320614429284
1941,CT,M,9026,3940,12966,30.3871664352923
1941,DC,F,6331,968,7299,13.262090697355802
1941,DC,M,5116,2372,7488,31.677350427350426
1941,DE,F,1697,280,1977,14.162873039959534
1941,DE,M,1338,600,1938,30.959752321981426
1941,FL,F,14106,2076,16182,12.829069336299593
1941,FL,M,12637,3989,16626,23.99254180199687
1941,GA,F,28279,4259,32538,13.089310959493517
1941,GA,M,25317,7118,32435,21.945429320178818
1941,HI,F,3290,302,3592,8.407572383073497
1941,HI,M,3100,823,3923,20.97884272240632
1941,IA,F,17128,3185,20313,15.67961404026978
1941,IA,M,17385,4203,21588,19.469149527515288
1941,ID,F,3856,517,4373,11.822547450262977
1941,ID,M,3929,854,4783,17.85490278068158
1941,IL,F,52565,8545,61110,13.982981508754705
1941,IL,M,48046,15871,63917,24.830639735907507
1941,IN,F,23991,4786,28777,16.631337526496857
1941,IN,M,22487,7598,30085,25.255110520192787
1941,KS,F,10902,1879,12781,14.701510053986386
1941,KS,M,11285,2276,13561,16.78342305139739
1941,KY,F,24510,4097,28607,14.321669521445802
1941,KY,M,22452,6021,28473,21.146349172900642
1941,LA,F,21864,2839,24703,11.492531271505484
1941,LA,M,19070,5296,24366,21.7352047935648
1941,MA,F,27753,3912,31665,12.354334438654666
1941,MA,M,22485,10825,33310,32.49774842389673
1941,MD,F,12779,1950,14729,13.239187996469552
1941,MD,M,11147,4031,15178,26.55817630781394
1941,ME,F,5606,792,6398,12.378868396373868
1941,ME,M,5247,1556,6803,22.872262237248272
1941,MI,F,40749,7110,47859,14.856139910988528
1941,MI,M,37501,12357,49858,24.78438766095712
1941,MN,F,19713,3503,23216,15.088731909028255
1941,MN,M,18700,5985,24685,24.245493214502734
1941,MO,F,25520,4292,29812,14.396887159533073
1941,MO,M,24594,6420,31014,20.70032888372993
1941,MS,F,20142,2934,23076,12.714508580343214
1941,MS,M,17151,4955,22106,22.414729032841763
1941,MT,F,3743,598,4341,13.775627735544804
1941,MT,M,3787,980,4767,20.558002936857562
1941,NC,F,34200,4804,39004,12.316685468157113
1941,NC,M,29844,8850,38694,22.871763064040938
1941,ND,F,4650,635,5285,12.015137180700094
1941,ND,M,4674,971,5645,17.20106288751107
1941,NE,F,7629,1359,8988,15.120160213618158
1941,NE,M,8333,1650,9983,16.528097766202542
1941,NH,F,3006,406,3412,11.899179366940212
1941,NH,M,2660,909,3569,25.46931913701317
1941,NJ,F,25968,3197,29165,10.961769243956798
1941,NJ,M,21348,8989,30337,29.63048422718133
1941,NM,F,4979,894,5873,15.222203303252172
1941,NM,M,4941,1073,6014,17.841702693714666
1941,NV,F,438,59,497,11.87122736418511
1941,NV,M,510,186,696,26.72413793103448
1941,NY,F,86260,10166,96426,10.54279965984278
1941,NY,M,70166,30243,100409,30.119809977193277
1941,OH,F,49368,7781,57149,13.615286356716652
1941,OH,M,43832,15610,59442,26.260892971299754
1941,OK,F,17785,2467,20252,12.181512936993876
1941,OK,M,18094,3629,21723,16.705795700409702
1941,OR,F,6668,1032,7700,13.402597402597403
1941,OR,M,6617,1723,8340,20.65947242206235
1941,PA,F,68660,9906,78566,12.608507496881602
1941,PA,M,57096,23906,81002,29.51285153453001
1941,RI,F,4372,490,4862,10.078157136980666
1941,RI,M,3480,1463,4943,29.597410479465914
1941,SC,F,19297,3201,22498,14.227931371677482
1941,SC,M,16127,5583,21710,25.716259788116076
1941,SD,F,3949,668,4617,14.468269439029674
1941,SD,M,4216,929,5145,18.056365403304177
1941,TN,F,25531,3858,29389,13.127360577086666
1941,TN,M,23262,6379,29641,21.52086636753146
1941,TX,F,56624,7130,63754,11.183612008658281
1941,TX,M,54294,12213,66507,18.363480535883443
1941,UT,F,4499,568,5067,11.209788829682257
1941,UT,M,4647,1187,5834,20.346246143297908
1941,VA,F,22887,3178,26065,12.192595434490697
1941,VA,M,20040,5702,25742,22.150571051200373
1941,VT,F,2222,279,2501,11.155537784886045
1941,VT,M,1973,664,2637,25.180128934395146
1941,WA,F,11106,1718,12824,13.3967560823456
1941,WA,M,10646,3104,13750,22.574545454545454
1941,WI,F,21062,3945,25007,15.775582836805693
1941,WI,M,19405,7079,26484,26.729346020238637
1941,WV,F,16872,2707,19579,13.826038102048113
1941,WV,M,15489,4348,19837,21.918636890658867
1941,WY,F,1387,307,1694,18.122786304604485
1941,WY,M,1538,386,1924,20.062370062370064
1942,AK,F,304,99,403,24.56575682382134
1942,AK,M,271,176,447,39.37360178970917
1942,AL,F,28532,4549,33081,13.751095795169432
1942,AL,M,25371,7336,32707,22.429449353349437
1942,AR,F,17899,2471,20370,12.130584192439862
1942,AR,M,16885,4077,20962,19.44948001144929
1942,AZ,F,5064,783,5847,13.391482811698307
1942,AZ,M,4839,1192,6031,19.76454982589952
1942,CA,F,61054,7959,69013,11.532609798153972
1942,CA,M,56159,16855,73014,23.08461390966116
1942,CO,F,8485,1422,9907,14.353487433128093
1942,CO,M,8255,2386,10641,22.422704633023212
1942,CT,F,13930,1708,15638,10.922112802148613
1942,CT,M,11467,5230,16697,31.322992154279213
1942,DC,F,7513,1085,8598,12.619213770644336
1942,DC,M,6351,2819,9170,30.74154852780807
1942,DE,F,1819,287,2106,13.627730294396962
1942,DE,M,1534,725,2259,32.09384683488269
1942,FL,F,15425,2365,17790,13.29398538504778
1942,FL,M,14074,4534,18608,24.365864144453997
1942,GA,F,30602,4556,35158,12.9586438363957
1942,GA,M,27572,7738,35310,21.91447182101388
1942,HI,F,3423,299,3722,8.033315421816228
1942,HI,M,3307,880,4187,21.017434917602102
1942,IA,F,17866,3256,21122,15.415206893286621
1942,IA,M,18149,4722,22871,20.646233221109703
1942,ID,F,3767,568,4335,13.102652825836216
1942,ID,M,3866,980,4846,20.222864217911678
1942,IL,F,60731,9770,70501,13.857959461567921
1942,IL,M,55144,18749,73893,25.37317472561677
1942,IN,F,26781,5171,31952,16.18365047571357
1942,IN,M,25244,8986,34230,26.251825883727726
1942,KS,F,11867,2087,13954,14.956284936219005
1942,KS,M,12551,2730,15281,17.865322950068713
1942,KY,F,25192,4117,29309,14.046879798014261
1942,KY,M,23566,6442,30008,21.467608637696614
1942,LA,F,23257,3003,26260,11.435643564356436
1942,LA,M,20518,5655,26173,21.606235433461965
1942,MA,F,33359,4506,37865,11.900171662485144
1942,MA,M,26498,13112,39610,33.10275183034587
1942,MD,F,15446,2258,17704,12.754179846362405
1942,MD,M,13461,4875,18336,26.587041884816752
1942,ME,F,6239,896,7135,12.557813594954451
1942,ME,M,5794,1793,7587,23.632529326479503
1942,MI,F,47658,8065,55723,14.473377240995639
1942,MI,M,42996,14898,57894,25.733236604829518
1942,MN,F,21538,3847,25385,15.154618869411069
1942,MN,M,20035,6703,26738,25.0691899169721
1942,MO,F,27549,4796,32345,14.827639511516463
1942,MO,M,26310,7391,33701,21.93109996736002
1942,MS,F,21283,3056,24339,12.555980114219976
1942,MS,M,18488,5231,23719,22.054049496184494
1942,MT,F,3700,643,4343,14.805434031775269
1942,MT,M,3834,1031,4865,21.19218910585817
1942,NC,F,36743,5162,41905,12.318339100346021
1942,NC,M,32058,9603,41661,23.050334845538995
1942,ND,F,4632,719,5351,13.436740796112876
1942,ND,M,4663,1029,5692,18.078004216444132
1942,NE,F,8395,1474,9869,14.935657108116324
1942,NE,M,8870,1852,10722,17.272896847603057
1942,NH,F,3471,425,3896,10.908624229979466
1942,NH,M,3042,1027,4069,25.23961661341853
1942,NJ,F,31925,3751,35676,10.514071084202264
1942,NJ,M,26126,11295,37421,30.18358675609952
1942,NM,F,4937,897,5834,15.375385670209118
1942,NM,M,4940,1119,6059,18.468394124442977
1942,NV,F,628,107,735,14.557823129251702
1942,NV,M,630,219,849,25.795053003533567
1942,NY,F,101559,11465,113024,10.143863250283127
1942,NY,M,81927,35932,117859,30.487277170177922
1942,OH,F,57020,8849,65869,13.434240689854104
1942,OH,M,49890,18404,68294,26.948194570533285
1942,OK,F,17833,2559,20392,12.549038838760298
1942,OK,M,17784,3683,21467,17.156565891833978
1942,OR,F,7861,1193,9054,13.176496576098963
1942,OR,M,7963,2252,10215,22.04601076847773
1942,PA,F,79059,10992,90051,12.206416364060365
1942,PA,M,65209,27998,93207,30.038516420440526
1942,RI,F,5225,570,5795,9.836065573770492
1942,RI,M,4238,1909,6147,31.055799577029447
1942,SC,F,20556,3237,23793,13.604841760181566
1942,SC,M,17764,6012,23776,25.28600269179004
1942,SD,F,4034,668,4702,14.206720544449169
1942,SD,M,4238,911,5149,17.692755874927172
1942,TN,F,27317,4010,31327,12.800459667379577
1942,TN,M,24898,7038,31936,22.037825651302605
1942,TX,F,59426,7562,66988,11.288589001015108
1942,TX,M,56772,13700,70472,19.440345101600638
1942,UT,F,5375,644,6019,10.699451736168799
1942,UT,M,5562,1406,6968,20.177956371986223
1942,VA,F,25660,3544,29204,12.13532392822901
1942,VA,M,22590,6954,29544,23.537774167343624
1942,VT,F,2175,343,2518,13.621922160444797
1942,VT,M,2141,715,2856,25.035014005602243
1942,WA,F,14038,2204,16242,13.569757419037066
1942,WA,M,13534,3974,17508,22.698195110806488
1942,WI,F,23717,4535,28252,16.051960923120486
1942,WI,M,21481,8106,29587,27.397167674992396
1942,WV,F,17698,2856,20554,13.895105575557068
1942,WV,M,16090,4770,20860,22.866730584851393
1942,WY,F,1468,278,1746,15.922107674684993
1942,WY,M,1627,442,2069,21.36297728371194
1943,AK,F,316,104,420,24.761904761904763
1943,AK,M,318,175,493,35.496957403651116
1943,AL,F,29568,4427,33995,13.022503309310194
1943,AL,M,26443,7832,34275,22.85047410649161
1943,AR,F,18196,2576,20772,12.401309455035625
1943,AR,M,16893,4139,21032,19.679535945226323
1943,AZ,F,5573,926,6499,14.248345899369133
1943,AZ,M,5616,1421,7037,20.193264175074603
1943,CA,F,68791,9176,77967,11.769081791014147
1943,CA,M,62637,19199,81836,23.46033530475585
1943,CO,F,8858,1591,10449,15.22633744855967
1943,CO,M,8557,2526,11083,22.791662907155104
1943,CT,F,14515,1831,16346,11.20151719075003
1943,CT,M,12080,5666,17746,31.928321875352196
1943,DC,F,8342,1302,9644,13.500622148486105
1943,DC,M,6625,3092,9717,31.820520736852938
1943,DE,F,2015,298,2313,12.88370082144401
1943,DE,M,1762,808,2570,31.439688715953306
1943,FL,F,18078,2756,20834,13.22837669194586
1943,FL,M,16218,5603,21821,25.67710004124467
1943,GA,F,31880,4651,36531,12.731652569050944
1943,GA,M,28384,8308,36692,22.642537882917257
1943,HI,F,3918,359,4277,8.393733925648819
1943,HI,M,3890,1027,4917,20.886719544437664
1943,IA,F,17460,3273,20733,15.786427434524672
1943,IA,M,17398,4905,22303,21.992557055104694
1943,ID,F,3951,569,4520,12.58849557522124
1943,ID,M,4299,956,5255,18.19219790675547
1943,IL,F,60276,9819,70095,14.008131821099937
1943,IL,M,53803,19135,72938,26.23461021689654
1943,IN,F,27139,5385,32524,16.557004058541384
1943,IN,M,24984,9241,34225,27.00073046018992
1943,KS,F,12493,2231,14724,15.152132572670471
1943,KS,M,13057,3075,16132,19.061492685345897
1943,KY,F,24846,4109,28955,14.19098601277845
1943,KY,M,23036,6564,29600,22.175675675675677
1943,LA,F,24331,3148,27479,11.45602096146148
1943,LA,M,21339,5796,27135,21.359867330016584
1943,MA,F,34125,4688,38813,12.078427331048875
1943,MA,M,27416,13513,40929,33.01571013218012
1943,MD,F,16239,2616,18855,13.874303898170245
1943,MD,M,14219,5393,19612,27.49847032429125
1943,ME,F,6727,968,7695,12.57959714100065
1943,ME,M,6004,2011,8015,25.09045539613225
1943,MI,F,48012,8342,56354,14.802853391063634
1943,MI,M,43114,15495,58609,26.4379190909246
1943,MN,F,21174,3960,25134,15.75555025065648
1943,MN,M,19709,6861,26570,25.82235604064735
1943,MO,F,27748,5150,32898,15.65444707884978
1943,MO,M,26865,7805,34670,22.512258436688782
1943,MS,F,21911,3155,25066,12.586770924758635
1943,MS,M,19306,5514,24820,22.215954875100724
1943,MT,F,3646,620,4266,14.533520862634786
1943,MT,M,3610,989,4599,21.504674929332463
1943,NC,F,37750,5306,43056,12.32348569305091
1943,NC,M,33558,9990,43548,22.94020391292367
1943,ND,F,4518,691,5209,13.265502015741983
1943,ND,M,4742,1101,5843,18.84306007188088
1943,NE,F,8663,1503,10166,14.784576037772968
1943,NE,M,9258,2043,11301,18.0780461906026
1943,NH,F,3389,454,3843,11.813687223523289
1943,NH,M,3071,1066,4137,25.767464346144546
1943,NJ,F,32294,3863,36157,10.683961611859392
1943,NJ,M,26248,11230,37478,29.964245690805274
1943,NM,F,5221,915,6136,14.91199478487614
1943,NM,M,5217,1194,6411,18.624239588207768
1943,NV,F,745,135,880,15.340909090909092
1943,NV,M,712,279,991,28.15338042381433
1943,NY,F,102230,12210,114440,10.669346382383782
1943,NY,M,83139,36512,119651,30.515415667232197
1943,OH,F,55737,9192,64929,14.157002264011458
1943,OH,M,49301,18611,67912,27.404582400753917
1943,OK,F,18574,2772,21346,12.986039539023706
1943,OK,M,18708,3859,22567,17.100190543714273
1943,OR,F,9064,1423,10487,13.56918089062649
1943,OR,M,8910,2651,11561,22.930542340627973
1943,PA,F,78894,11248,90142,12.47809012447028
1943,PA,M,64991,28358,93349,30.378472185026084
1943,RI,F,5448,687,6135,11.19804400977995
1943,RI,M,4482,1867,6349,29.406205701685305
1943,SC,F,21502,3432,24934,13.764337851929092
1943,SC,M,18051,6384,24435,26.126457949662367
1943,SD,F,4261,727,4988,14.574979951884522
1943,SD,M,4343,991,5334,18.578927634045744
1943,TN,F,28057,4041,32098,12.589569443579038
1943,TN,M,25648,7376,33024,22.33527131782946
1943,TX,F,65739,8594,74333,11.561486822810865
1943,TX,M,62627,15310,77937,19.6440714936423
1943,UT,F,6169,727,6896,10.542343387470998
1943,UT,M,6182,1570,7752,20.25283797729618
1943,VA,F,26632,3688,30320,12.16358839050132
1943,VA,M,23378,7186,30564,23.51132050778694
1943,VT,F,2273,326,2599,12.543285879184301
1943,VT,M,2187,751,2938,25.561606535057862
1943,WA,F,16214,2341,18555,12.616545405551063
1943,WA,M,15422,4691,20113,23.323223785611297
1943,WI,F,23454,4781,28235,16.93288471754914
1943,WI,M,21389,8240,29629,27.81059097505822
1943,WV,F,16758,2713,19471,13.933542190950646
1943,WV,M,15523,4650,20173,23.050612204431665
1943,WY,F,1616,294,1910,15.392670157068064
1943,WY,M,1659,491,2150,22.837209302325583
1944,AK,F,330,100,430,23.25581395348837
1944,AK,M,382,191,573,33.33333333333333
1944,AL,F,27985,4192,32177,13.027939211237841
1944,AL,M,25374,7171,32545,22.03410662160086
1944,AR,F,17019,2414,19433,12.422168476303195
1944,AR,M,16122,3930,20052,19.59904248952723
1944,AZ,F,5671,861,6532,13.181261481935088
1944,AZ,M,5409,1498,6907,21.688142464166788
1944,CA,F,70601,9226,79827,11.55749307878287
1944,CA,M,63883,20628,84511,24.408656861237
1944,CO,F,8750,1470,10220,14.383561643835616
1944,CO,M,8591,2663,11254,23.662697707481783
1944,CT,F,12652,1633,14285,11.431571578578929
1944,CT,M,10498,5011,15509,32.31027145528403
1944,DC,F,7972,1242,9214,13.47948773605383
1944,DC,M,6762,3165,9927,31.882744031429432
1944,DE,F,1900,322,2222,14.491449144914492
1944,DE,M,1667,767,2434,31.511914543960557
1944,FL,F,19495,2789,22284,12.515706336384849
1944,FL,M,17504,5993,23497,25.505383665999915
1944,GA,F,31092,4564,35656,12.800089746466234
1944,GA,M,28326,8147,36473,22.337071258190992
1944,HI,F,4255,460,4715,9.75609756097561
1944,HI,M,4086,1036,5122,20.226474033580633
1944,IA,F,17118,3041,20159,15.085073664368274
1944,IA,M,16845,4759,21604,22.028328087391223
1944,ID,F,4048,560,4608,12.152777777777777
1944,ID,M,4046,1029,5075,20.275862068965516
1944,IL,F,54728,8610,63338,13.593735198459061
1944,IL,M,48431,18150,66581,27.26002913744161
1944,IN,F,26045,4725,30770,15.355866103347415
1944,IN,M,23815,9361,33176,28.216180371352785
1944,KS,F,12251,2147,14398,14.911793304625643
1944,KS,M,12593,3116,15709,19.83576293844293
1944,KY,F,23850,3908,27758,14.078824122775416
1944,KY,M,22310,6412,28722,22.324350671958776
1944,LA,F,23657,3164,26821,11.796726445695537
1944,LA,M,21017,5958,26975,22.087117701575533
1944,MA,F,31296,4188,35484,11.802502536354414
1944,MA,M,24600,12773,37373,34.17707970995104
1944,MD,F,15604,2423,18027,13.440949686581238
1944,MD,M,13097,5193,18290,28.392564242755604
1944,ME,F,6298,972,7270,13.370013755158183
1944,ME,M,5696,1950,7646,25.50353125817421
1944,MI,F,43408,7193,50601,14.215134088259127
1944,MI,M,39045,14293,53338,26.79703025985226
1944,MN,F,20242,3551,23793,14.924557643004244
1944,MN,M,18780,6785,25565,26.540191668296497
1944,MO,F,26058,4664,30722,15.18130330056637
1944,MO,M,24915,7533,32448,23.215606508875737
1944,MS,F,21132,2876,24008,11.97934021992669
1944,MS,M,18500,5252,23752,22.111822162344225
1944,MT,F,3419,556,3975,13.9874213836478
1944,MT,M,3488,1003,4491,22.33355600089067
1944,NC,F,36240,4909,41149,11.929816034411528
1944,NC,M,32208,9758,41966,23.25215650764905
1944,ND,F,4705,722,5427,13.30385111479639
1944,ND,M,4559,1154,5713,20.19954489760196
1944,NE,F,8633,1419,10052,14.116593712693993
1944,NE,M,8909,2224,11133,19.97664600736549
1944,NH,F,2949,406,3355,12.10134128166915
1944,NH,M,2684,1015,3699,27.43984860773182
1944,NJ,F,29238,3493,32731,10.671840151538298
1944,NJ,M,23791,10661,34452,30.944502496226633
1944,NM,F,5361,972,6333,15.348176219801044
1944,NM,M,5527,1283,6810,18.839941262848754
1944,NV,F,769,113,882,12.811791383219957
1944,NV,M,765,332,1097,30.264357338195076
1944,NY,F,94115,11337,105452,10.750862951864356
1944,NY,M,75787,34420,110207,31.232135889734774
1944,OH,F,51557,8307,59864,13.87645329413337
1944,OH,M,44872,17624,62496,28.200204813108037
1944,OK,F,17683,2602,20285,12.827212225782597
1944,OK,M,17741,3815,21556,17.698088699202078
1944,OR,F,8676,1281,9957,12.865320879783068
1944,OR,M,8402,2708,11110,24.374437443744373
1944,PA,F,69805,10090,79895,12.629075661806121
1944,PA,M,57480,26178,83658,31.291687585168187
1944,RI,F,5097,609,5706,10.67297581493165
1944,RI,M,4193,1832,6025,30.406639004149376
1944,SC,F,20660,3163,23823,13.277085169793898
1944,SC,M,17738,6144,23882,25.726488568796587
1944,SD,F,4071,698,4769,14.636192073810022
1944,SD,M,4225,1044,5269,19.81400645283735
1944,TN,F,27238,3848,31086,12.378562697034035
1944,TN,M,24762,7125,31887,22.344529118449525
1944,TX,F,67017,8670,75687,11.455071544650997
1944,TX,M,63022,15867,78889,20.11307026328132
1944,UT,F,5893,711,6604,10.766202301635373
1944,UT,M,5560,1591,7151,22.248636554328066
1944,VA,F,25778,3600,29378,12.254067669684797
1944,VA,M,22435,7044,29479,23.894976084670443
1944,VT,F,2211,349,2560,13.6328125
1944,VT,M,1834,750,2584,29.024767801857585
1944,WA,F,16475,2300,18775,12.250332889480692
1944,WA,M,15320,4776,20096,23.76592356687898
1944,WI,F,22289,4348,26637,16.323159514960395
1944,WI,M,20154,8215,28369,28.957665056928338
1944,WV,F,15703,2601,18304,14.210008741258742
1944,WV,M,14434,4435,18869,23.504160262865017
1944,WY,F,1617,264,1881,14.035087719298245
1944,WY,M,1671,485,2156,22.495361781076067
1945,AK,F,370,77,447,17.225950782997764
1945,AK,M,320,152,472,32.20338983050847
1945,AL,F,27140,4089,31229,13.093598898459765
1945,AL,M,24212,7074,31286,22.61075241321997
1945,AR,F,16077,2241,18318,12.233868326236488
1945,AR,M,15059,3699,18758,19.719586309841134
1945,AZ,F,5280,794,6074,13.072110635495553
1945,AZ,M,5385,1411,6796,20.76221306650971
1945,CA,F,74404,9098,83502,10.895547412038036
1945,CA,M,66083,22170,88253,25.12095906088178
1945,CO,F,8862,1390,10252,13.558330081935232
1945,CO,M,8340,2744,11084,24.75640562973656
1945,CT,F,12511,1591,14102,11.28208764714225
1945,CT,M,10302,4921,15223,32.326085528476646
1945,DC,F,8246,1183,9429,12.546399406087602
1945,DC,M,6786,3237,10023,32.295719844357976
1945,DE,F,1863,317,2180,14.541284403669724
1945,DE,M,1685,769,2454,31.33659331703341
1945,FL,F,19615,2831,22446,12.612492203510648
1945,FL,M,17387,6106,23493,25.990720640190695
1945,GA,F,30255,4137,34392,12.028960223307745
1945,GA,M,27224,7607,34831,21.83974046108352
1945,HI,F,4124,440,4564,9.640666082383873
1945,HI,M,3968,1078,5046,21.363456202933016
1945,IA,F,16882,2755,19637,14.029637928400469
1945,IA,M,15942,4805,20747,23.159974936135345
1945,ID,F,3899,518,4417,11.727416798732172
1945,ID,M,3721,912,4633,19.68486941506583
1945,IL,F,53509,8021,61530,13.035917438647814
1945,IL,M,47026,18293,65319,28.0056338890675
1945,IN,F,25151,4395,29546,14.875109997969268
1945,IN,M,22924,8906,31830,27.9798931825322
1945,KS,F,11743,1933,13676,14.134249780637614
1945,KS,M,12060,3148,15208,20.699631772751186
1945,KY,F,23185,3677,26862,13.688481870300052
1945,KY,M,21438,6134,27572,22.24720731176556
1945,LA,F,22821,2842,25663,11.074309316915404
1945,LA,M,19990,5592,25582,21.859119693534517
1945,MA,F,30731,3994,34725,11.50179985601152
1945,MA,M,24159,12655,36814,34.37550931710762
1945,MD,F,15222,2294,17516,13.096597396665905
1945,MD,M,13220,5320,18540,28.694714131607334
1945,ME,F,5883,823,6706,12.272591708917387
1945,ME,M,5417,1905,7322,26.01748156241464
1945,MI,F,42999,6861,49860,13.760529482551142
1945,MI,M,38095,14529,52624,27.60907570690179
1945,MN,F,20159,3358,23517,14.27903218947995
1945,MN,M,18142,6688,24830,26.935159081755938
1945,MO,F,25429,4460,29889,14.921877613837866
1945,MO,M,23907,7742,31649,24.462068311795
1945,MS,F,20489,2813,23302,12.071925156638915
1945,MS,M,17773,5050,22823,22.126801910353592
1945,MT,F,3355,490,3845,12.743823146944083
1945,MT,M,3344,1097,4441,24.701643773924793
1945,NC,F,35863,4708,40571,11.604347933252816
1945,NC,M,31613,9685,41298,23.451498861930357
1945,ND,F,4635,726,5361,13.542249580302181
1945,ND,M,4367,1184,5551,21.329490181949197
1945,NE,F,8566,1377,9943,13.848938952026552
1945,NE,M,8666,2374,11040,21.503623188405797
1945,NH,F,2856,435,3291,13.217866909753875
1945,NH,M,2587,1109,3696,30.005411255411257
1945,NJ,F,29917,3435,33352,10.299232429839291
1945,NJ,M,24143,10974,35117,31.24982202352137
1945,NM,F,5260,879,6139,14.318292881576806
1945,NM,M,5255,1316,6571,20.02739309085375
1945,NV,F,801,130,931,13.963480128893663
1945,NV,M,768,331,1099,30.118289353958144
1945,NY,F,97179,11123,108302,10.270355118095695
1945,NY,M,78309,35702,114011,31.314522282937613
1945,OH,F,51673,8052,59725,13.481791544579321
1945,OH,M,44784,18225,63009,28.924439365804883
1945,OK,F,16251,2294,18545,12.369911027231058
1945,OK,M,16604,3594,20198,17.7938409743539
1945,OR,F,8583,1227,9810,12.507645259938837
1945,OR,M,8368,2749,11117,24.727894216065486
1945,PA,F,68631,9510,78141,12.170307521019694
1945,PA,M,56329,25831,82160,31.43987341772152
1945,RI,F,5068,627,5695,11.009657594381036
1945,RI,M,4154,1949,6103,31.935113878420452
1945,SC,F,20247,3101,23348,13.281651533321911
1945,SC,M,17089,6060,23149,26.178236640891615
1945,SD,F,3957,657,4614,14.23927178153446
1945,SD,M,4100,1110,5210,21.30518234165067
1945,TN,F,26253,3588,29841,12.023725746456218
1945,TN,M,23515,7003,30518,22.94711317910741
1945,TX,F,64338,7856,72194,10.881790730531623
1945,TX,M,61361,15630,76991,20.301074151524205
1945,UT,F,5621,601,6222,9.659273545483767
1945,UT,M,5575,1533,7108,21.567248171074844
1945,VA,F,25180,3487,28667,12.163812048697107
1945,VA,M,21895,7162,29057,24.648105447912723
1945,VT,F,2108,335,2443,13.71264838313549
1945,VT,M,1928,829,2757,30.06891548784911
1945,WA,F,16951,2155,19106,11.279179315398304
1945,WA,M,15474,4967,20441,24.299202583043883
1945,WI,F,22343,4171,26514,15.731311759824997
1945,WI,M,19924,8469,28393,29.8277744514493
1945,WV,F,15055,2446,17501,13.976344208902347
1945,WV,M,13873,4409,18282,24.116617437917075
1945,WY,F,1458,249,1707,14.586994727592268
1945,WY,M,1585,477,2062,23.132880698351116
1946,AK,F,472,104,576,18.055555555555554
1946,AK,M,455,238,693,34.34343434343434
1946,AL,F,31047,4360,35407,12.313949219080973
1946,AL,M,27832,7954,35786,22.226569049348907
1946,AR,F,18580,2500,21080,11.859582542694497
1946,AR,M,17881,4372,22253,19.646789196962207
1946,AZ,F,6318,877,7195,12.189020152883948
1946,AZ,M,6066,1682,7748,21.70882808466701
1946,CA,F,89098,10186,99284,10.25945771725555
1946,CA,M,79093,26556,105649,25.136063758293975
1946,CO,F,11111,1603,12714,12.608148497719048
1946,CO,M,10247,3502,13749,25.470943341333914
1946,CT,F,15634,1975,17609,11.215855528422965
1946,CT,M,12595,6312,18907,33.38446078172105
1946,DC,F,9271,1408,10679,13.18475512688454
1946,DC,M,7710,3681,11391,32.31498551488017
1946,DE,F,2365,356,2721,13.08342521131937
1946,DE,M,1939,930,2869,32.41547577553155
1946,FL,F,21537,2840,24377,11.650326127087009
1946,FL,M,19112,6322,25434,24.856491310843754
1946,GA,F,34941,4566,39507,11.557445515984508
1946,GA,M,31228,9034,40262,22.438030897620585
1946,HI,F,4328,442,4770,9.266247379454926
1946,HI,M,4174,1126,5300,21.245283018867926
1946,IA,F,21231,3244,24475,13.254341164453523
1946,IA,M,20266,6625,26891,24.636495481759695
1946,ID,F,4570,558,5128,10.881435257410295
1946,ID,M,4596,1172,5768,20.31900138696255
1946,IL,F,68264,9888,78152,12.652267376394718
1946,IL,M,59528,23063,82591,27.92435011078689
1946,IN,F,32310,5362,37672,14.233382883839457
1946,IN,M,28695,11440,40135,28.503799676093184
1946,KS,F,14412,2178,16590,13.128390596745026
1946,KS,M,14038,3869,17907,21.60607583626515
1946,KY,F,28002,4423,32425,13.640709329221279
1946,KY,M,25950,7672,33622,22.818392719053
1946,LA,F,26994,3286,30280,10.852047556142669
1946,LA,M,24060,6834,30894,22.120800155369974
1946,MA,F,39687,4814,44501,10.817734432934092
1946,MA,M,30692,16193,46885,34.53769862429348
1946,MD,F,18311,2753,21064,13.069692366122293
1946,MD,M,15952,6044,21996,27.477723222404073
1946,ME,F,7353,1044,8397,12.433011789924974
1946,ME,M,6556,2450,9006,27.204086164779035
1946,MI,F,54220,7870,62090,12.675148977291029
1946,MI,M,47372,18403,65775,27.978715317369822
1946,MN,F,25555,4077,29632,13.758774298056156
1946,MN,M,22272,8729,31001,28.15715622076707
1946,MO,F,31453,5219,36672,14.231566317626527
1946,MO,M,29316,9645,38961,24.755524755524753
1946,MS,F,23510,3046,26556,11.470100918813074
1946,MS,M,20874,5885,26759,21.992600620352032
1946,MT,F,4209,643,4852,13.252267106347897
1946,MT,M,4243,1341,5584,24.015042979942695
1946,NC,F,41333,5306,46639,11.376744784407899
1946,NC,M,36652,10964,47616,23.02587365591398
1946,ND,F,5370,786,6156,12.76803118908382
1946,ND,M,5188,1313,6501,20.196892785725275
1946,NE,F,10084,1547,11631,13.30066202390164
1946,NE,M,9887,2836,12723,22.290340328538864
1946,NH,F,4041,536,4577,11.710727550797467
1946,NH,M,3608,1438,5046,28.4978200554895
1946,NJ,F,37188,4244,41432,10.243290210465341
1946,NJ,M,30277,13702,43979,31.155778894472363
1946,NM,F,6277,1017,7294,13.942966822045516
1946,NM,M,6164,1486,7650,19.424836601307188
1946,NV,F,821,123,944,13.029661016949154
1946,NV,M,816,330,1146,28.79581151832461
1946,NY,F,119225,13292,132517,10.030411192526243
1946,NY,M,96004,44367,140371,31.606955852704615
1946,OH,F,67164,9701,76865,12.620828725687893
1946,OH,M,57570,23607,81177,29.080897298495877
1946,OK,F,19156,2573,21729,11.841318054213264
1946,OK,M,18910,4342,23252,18.673662480646826
1946,OR,F,11296,1459,12755,11.438651509212074
1946,OR,M,10587,3494,14081,24.813578581066686
1946,PA,F,87366,11865,99231,11.956948937328054
1946,PA,M,71495,32962,104457,31.555568319978555
1946,RI,F,6299,728,7027,10.360039846307101
1946,RI,M,5177,2383,7560,31.521164021164022
1946,SC,F,22559,3208,25767,12.450032987930298
1946,SC,M,19280,6670,25950,25.703275529865127
1946,SD,F,4928,739,5667,13.040409387683077
1946,SD,M,4896,1355,6251,21.67653175491921
1946,TN,F,31861,4208,36069,11.666528043472233
1946,TN,M,28751,8462,37213,22.73936527557574
1946,TX,F,74019,9037,83056,10.880610672317474
1946,TX,M,70905,18238,89143,20.45926208451589
1946,UT,F,6607,658,7265,9.057123193392979
1946,UT,M,6371,1782,8153,21.85698515883724
1946,VA,F,28576,3736,32312,11.562267888091112
1946,VA,M,25148,7978,33126,24.08380124373604
1946,VT,F,2749,382,3131,12.200574896199297
1946,VT,M,2417,949,3366,28.19370172311349
1946,WA,F,19992,2372,22364,10.606331604364156
1946,WA,M,18347,5991,24338,24.61582710165174
1946,WI,F,28016,4788,32804,14.59578100231679
1946,WI,M,24289,10324,34613,29.826943633894782
1946,WV,F,18821,3038,21859,13.898165515348367
1946,WV,M,17531,5676,23207,24.458137630887233
1946,WY,F,1741,273,2014,13.555114200595831
1946,WY,M,1758,620,2378,26.07232968881413
1947,AK,F,663,125,788,15.862944162436548
1947,AK,M,593,316,909,34.763476347634764
1947,AL,F,34729,4574,39303,11.637788463984936
1947,AL,M,30836,9111,39947,22.807720229303825
1947,AR,F,20645,2720,23365,11.641343890434412
1947,AR,M,19259,4778,24037,19.87768856346466
1947,AZ,F,7371,996,8367,11.903908210828254
1947,AZ,M,7120,2075,9195,22.566612289287658
1947,CA,F,102176,10694,112870,9.474616815805796
1947,CA,M,88743,30671,119414,25.684593096286868
1947,CO,F,12650,1698,14348,11.834402007248396
1947,CO,M,11416,3996,15412,25.927848429794963
1947,CT,F,17377,2064,19441,10.616737822128492
1947,CT,M,13900,7094,20994,33.790606840049534
1947,DC,F,10341,1369,11710,11.690862510674636
1947,DC,M,8440,4077,12517,32.57170248462092
1947,DE,F,2774,389,3163,12.298450837812204
1947,DE,M,2255,1028,3283,31.312823636917454
1947,FL,F,24037,3065,27102,11.30912847760313
1947,FL,M,21591,7220,28811,25.05987296518691
1947,GA,F,38744,4942,43686,11.312548642585725
1947,GA,M,34952,10075,45027,22.375463610722456
1947,HI,F,4921,478,5399,8.853491387293943
1947,HI,M,4852,1267,6119,20.705997712044454
1947,IA,F,25063,3341,28404,11.76242782706661
1947,IA,M,22547,7719,30266,25.503865723914625
1947,ID,F,5433,602,6035,9.975144987572495
1947,ID,M,5379,1416,6795,20.838852097130243
1947,IL,F,78023,10269,88292,11.630725320527342
1947,IL,M,66091,27003,93094,29.006165810900807
1947,IN,F,37372,5596,42968,13.02364550363061
1947,IN,M,31820,13269,45089,29.42846370511655
1947,KS,F,16190,2248,18438,12.192211736630872
1947,KS,M,15691,4389,20080,21.85756972111554
1947,KY,F,31437,4857,36294,13.382377252438419
1947,KY,M,28966,8611,37577,22.91561327407723
1947,LA,F,29411,3501,32912,10.637457462323772
1947,LA,M,26461,7573,34034,22.251278133631075
1947,MA,F,43826,5160,48986,10.533621851141142
1947,MA,M,33577,18588,52165,35.63308731908368
1947,MD,F,21013,3159,24172,13.068839980142313
1947,MD,M,18291,7318,25609,28.575891288218987
1947,ME,F,8828,1171,9999,11.71117111711171
1947,ME,M,7807,2922,10729,27.234597818995248
1947,MI,F,64371,8337,72708,11.466413599603895
1947,MI,M,54008,22225,76233,29.154040900922173
1947,MN,F,28867,4119,32986,12.48711574607409
1947,MN,M,25112,9900,35012,28.276019650405576
1947,MO,F,35625,5414,41039,13.19232924778869
1947,MO,M,32752,10941,43693,25.040624356304214
1947,MS,F,25679,3301,28980,11.390614216701172
1947,MS,M,22691,6466,29157,22.176492780464383
1947,MT,F,5068,657,5725,11.475982532751091
1947,MT,M,4831,1642,6473,25.366908697667235
1947,NC,F,46542,5865,52407,11.191253076879043
1947,NC,M,40881,12397,53278,23.26851608543864
1947,ND,F,6128,798,6926,11.52180190586197
1947,ND,M,5879,1569,7448,21.066058002148228
1947,NE,F,11883,1581,13464,11.742424242424242
1947,NE,M,11154,3448,14602,23.613203670730037
1947,NH,F,5117,600,5717,10.49501486793773
1947,NH,M,4263,1757,6020,29.186046511627907
1947,NJ,F,41886,4533,46419,9.765397789698184
1947,NJ,M,33847,15624,49471,31.582139030947427
1947,NM,F,7108,1088,8196,13.274768179599805
1947,NM,M,7168,1815,8983,20.20483134810197
1947,NV,F,1138,152,1290,11.782945736434108
1947,NV,M,1085,487,1572,30.979643765903308
1947,NY,F,136141,14255,150396,9.478310593366846
1947,NY,M,107247,50733,157980,32.11355867831371
1947,OH,F,79361,10741,90102,11.920934052518257
1947,OH,M,66626,28168,94794,29.714960862501844
1947,OK,F,20459,2600,23059,11.275423912572098
1947,OK,M,20186,4705,24891,18.902414527339197
1947,OR,F,13754,1573,15327,10.262934690415607
1947,OR,M,12713,4234,16947,24.983772939163273
1947,PA,F,100879,12796,113675,11.256652738069056
1947,PA,M,80881,37761,118642,31.827683282480066
1947,RI,F,7105,836,7941,10.527641354993074
1947,RI,M,5720,2749,8469,32.45955838942024
1947,SC,F,24812,3516,28328,12.411748093758824
1947,SC,M,21430,7324,28754,25.47123878416916
1947,SD,F,5721,773,6494,11.903295349553433
1947,SD,M,5529,1640,7169,22.876272841400475
1947,TN,F,35576,4562,40138,11.365788031292043
1947,TN,M,32520,9566,42086,22.729648814332556
1947,TX,F,82197,9517,91714,10.37682360381185
1947,TX,M,77752,20303,98055,20.705726378053132
1947,UT,F,7955,692,8647,8.002775529085232
1947,UT,M,7716,2165,9881,21.910737779576966
1947,VA,F,33179,4070,37249,10.926467824639587
1947,VA,M,28859,9451,38310,24.669799008091882
1947,VT,F,3224,449,3673,12.224339776749252
1947,VT,M,2848,1122,3970,28.261964735516372
1947,WA,F,23298,2521,25819,9.76412719315233
1947,WA,M,20542,6971,27513,25.337113364591286
1947,WI,F,32125,5064,37189,13.616929737287908
1947,WI,M,27043,12039,39082,30.804462412363748
1947,WV,F,21635,3399,25034,13.577534553007908
1947,WV,M,19519,6678,26197,25.491468488758258
1947,WY,F,2198,310,2508,12.360446570972886
1947,WY,M,2109,720,2829,25.45068928950159
1948,AK,F,776,159,935,17.005347593582886
1948,AK,M,738,422,1160,36.37931034482759
1948,AL,F,33432,4453,37885,11.753992345255378
1948,AL,M,30094,8829,38923,22.683246409577883
1948,AR,F,19745,2658,22403,11.864482435388117
1948,AR,M,18339,4533,22872,19.818992654774398
1948,AZ,F,7644,1042,8686,11.996315910660833
1948,AZ,M,7104,2110,9214,22.899934881701757
1948,CA,F,100782,10634,111416,9.544410138579737
1948,CA,M,86175,31435,117610,26.728169373352607
1948,CO,F,12825,1673,14498,11.539522692785212
1948,CO,M,11427,4198,15625,26.867200000000004
1948,CT,F,15795,1977,17772,11.12424037812289
1948,CT,M,12532,6714,19246,34.885170944611865
1948,DC,F,9768,1357,11125,12.197752808988763
1948,DC,M,8282,4055,12337,32.868606630461215
1948,DE,F,2438,404,2842,14.215341308937369
1948,DE,M,2087,1010,3097,32.61220536002583
1948,FL,F,23703,3077,26780,11.48991784914115
1948,FL,M,21057,7357,28414,25.89216583374393
1948,GA,F,37364,4752,42116,11.28312280368506
1948,GA,M,33871,9794,43665,22.429863735257072
1948,HI,F,4824,487,5311,9.169647900583694
1948,HI,M,4661,1390,6051,22.971409684349695
1948,IA,F,23466,3171,26637,11.904493749296092
1948,IA,M,21537,7378,28915,25.51616807885181
1948,ID,F,5427,594,6021,9.865470852017937
1948,ID,M,5293,1449,6742,21.49213883120736
1948,IL,F,74103,9685,83788,11.558934453621044
1948,IL,M,61820,26173,87993,29.744411487277393
1948,IN,F,35763,5305,41068,12.917600077919547
1948,IN,M,30523,13115,43638,30.054081305284384
1948,KS,F,15488,2097,17585,11.924936025021324
1948,KS,M,14713,4526,19239,23.52513124382764
1948,KY,F,30290,4441,34731,12.786847484955805
1948,KY,M,27414,8673,36087,24.033585501704216
1948,LA,F,28927,3374,32301,10.445497043435187
1948,LA,M,26348,7543,33891,22.25664630727922
1948,MA,F,40956,5006,45962,10.891606109394719
1948,MA,M,30368,17983,48351,37.19261235548386
1948,MD,F,19609,2937,22546,13.026700966912092
1948,MD,M,17117,6950,24067,28.877716375119455
1948,ME,F,8100,1102,9202,11.975657465768311
1948,ME,M,6955,2863,9818,29.16072519861479
1948,MI,F,61509,8004,69513,11.514392991239049
1948,MI,M,51656,21746,73402,29.62589575215934
1948,MN,F,28059,3894,31953,12.186649140925734
1948,MN,M,23909,10000,33909,29.49069568551122
1948,MO,F,33801,5095,38896,13.099033319621556
1948,MO,M,30047,10862,40909,26.551614559143466
1948,MS,F,25314,3275,28589,11.455454895239429
1948,MS,M,22111,6286,28397,22.136141141669892
1948,MT,F,5199,639,5838,10.945529290853031
1948,MT,M,4613,1653,6266,26.380466007022026
1948,NC,F,44672,5616,50288,11.167674196627427
1948,NC,M,39446,11989,51435,23.309030815592497
1948,ND,F,5912,822,6734,12.206712206712208
1948,ND,M,5719,1595,7314,21.807492480175007
1948,NE,F,11481,1592,13073,12.177770978352328
1948,NE,M,10807,3476,14283,24.336623958552124
1948,NH,F,4733,637,5370,11.86219739292365
1948,NH,M,3861,1786,5647,31.62741278554985
1948,NJ,F,38661,4222,42883,9.845393279388102
1948,NJ,M,30787,14575,45362,32.130417530091265
1948,NM,F,7354,1101,8455,13.02188054405677
1948,NM,M,7103,1879,8982,20.919617011801382
1948,NV,F,975,133,1108,12.00361010830325
1948,NV,M,910,418,1328,31.475903614457827
1948,NY,F,127713,13615,141328,9.633618249745274
1948,NY,M,99813,48488,148301,32.69566624635033
1948,OH,F,74474,10532,85006,12.389713667270545
1948,OH,M,62234,27142,89376,30.368331543143572
1948,OK,F,19159,2471,21630,11.423948220064725
1948,OK,M,18646,4714,23360,20.179794520547944
1948,OR,F,13290,1464,14754,9.922732818218789
1948,OR,M,11928,4230,16158,26.17898254734497
1948,PA,F,92068,11748,103816,11.316174770748248
1948,PA,M,74113,35506,109619,32.39037028252402
1948,RI,F,6493,753,7246,10.391940380899808
1948,RI,M,5389,2664,8053,33.08083943871849
1948,SC,F,24050,3425,27475,12.465878070973613
1948,SC,M,20788,7355,28143,26.134385104644135
1948,SD,F,5943,781,6724,11.61511005353956
1948,SD,M,5498,1781,7279,24.46764665476027
1948,TN,F,33650,4345,37995,11.43571522568759
1948,TN,M,30199,9266,39465,23.479032053718484
1948,TX,F,81857,9625,91482,10.521195426422684
1948,TX,M,77204,20778,97982,21.205935784123614
1948,UT,F,7632,664,8296,8.003857280617165
1948,UT,M,7308,2085,9393,22.197381028425422
1948,VA,F,31696,3902,35598,10.961289960110118
1948,VA,M,27711,9165,36876,24.853563293198828
1948,VT,F,3021,447,3468,12.889273356401384
1948,VT,M,2732,1203,3935,30.571791613722997
1948,WA,F,22422,2382,24804,9.603289791969036
1948,WA,M,19302,7078,26380,26.830932524639877
1948,WI,F,31118,4819,35937,13.40957787238779
1948,WI,M,26036,12091,38127,31.712434757520917
1948,WV,F,20687,3251,23938,13.58091736987217
1948,WV,M,18419,6434,24853,25.88822274976864
1948,WY,F,2284,301,2585,11.644100580270793
1948,WY,M,2082,745,2827,26.353024407499113
1949,AK,F,850,187,1037,18.0327868852459
1949,AK,M,842,453,1295,34.980694980694985
1949,AL,F,32875,4549,37424,12.155301410859341
1949,AL,M,29709,9113,38822,23.47380351347174
1949,AR,F,19804,2536,22340,11.351835273052819
1949,AR,M,17843,4762,22605,21.066135810661358
1949,AZ,F,7875,1023,8898,11.496965610249495
1949,AZ,M,7285,2378,9663,24.60933457518369
1949,CA,F,102185,11025,113210,9.738538998321703
1949,CA,M,87195,33201,120396,27.576497558058406
1949,CO,F,12563,1692,14255,11.869519466853735
1949,CO,M,11373,4326,15699,27.555895279954136
1949,CT,F,15236,2020,17256,11.7060732498841
1949,CT,M,12070,6574,18644,35.260673675177
1949,DC,F,10075,1421,11496,12.360821155184412
1949,DC,M,8202,3969,12171,32.610303179689424
1949,DE,F,2503,422,2925,14.427350427350428
1949,DE,M,2093,1143,3236,35.321384425216316
1949,FL,F,23951,2983,26934,11.075220910373504
1949,FL,M,21693,7508,29201,25.711448238074038
1949,GA,F,37655,4950,42605,11.618354653209717
1949,GA,M,33831,10040,43871,22.885277290237287
1949,HI,F,4813,464,5277,8.792874739435286
1949,HI,M,4694,1415,6109,23.162547061712228
1949,IA,F,24046,3239,27285,11.870991387209088
1949,IA,M,21472,8131,29603,27.466810796203088
1949,ID,F,5558,578,6136,9.419817470664928
1949,ID,M,5194,1512,6706,22.546972860125262
1949,IL,F,75484,10327,85811,12.034587640279218
1949,IL,M,63198,27923,91121,30.643869141032255
1949,IN,F,36469,5530,41999,13.166980166194433
1949,IN,M,30946,13797,44743,30.83610844154393
1949,KS,F,15735,2241,17976,12.466622162883844
1949,KS,M,14748,5024,19772,25.409670240744486
1949,KY,F,29469,4601,34070,13.504549457000293
1949,KY,M,27091,8937,36028,24.805706672587988
1949,LA,F,29994,3573,33567,10.644382876038968
1949,LA,M,26808,8048,34856,23.089281615790682
1949,MA,F,39738,4982,44720,11.140429338103756
1949,MA,M,29330,17878,47208,37.870699881376034
1949,MD,F,19445,3018,22463,13.435427146863733
1949,MD,M,16539,7160,23699,30.212245242415293
1949,ME,F,8028,1103,9131,12.079728397765853
1949,ME,M,6848,2909,9757,29.814492159475247
1949,MI,F,62230,8441,70671,11.94407890082212
1949,MI,M,52648,23263,75911,30.645097548444888
1949,MN,F,28659,3834,32493,11.799464500046163
1949,MN,M,24151,10789,34940,30.878649112764737
1949,MO,F,33503,5234,38737,13.51162970803108
1949,MO,M,29835,11607,41442,28.007818155494423
1949,MS,F,25801,3360,29161,11.522238606357806
1949,MS,M,22728,6308,29036,21.724755475960876
1949,MT,F,5396,682,6078,11.220796314577164
1949,MT,M,4595,1741,6336,27.477904040404038
1949,NC,F,43643,5403,49046,11.016188883904904
1949,NC,M,38355,12117,50472,24.007370423204947
1949,ND,F,5869,801,6670,12.008995502248876
1949,ND,M,5714,1637,7351,22.269079036865733
1949,NE,F,11878,1566,13444,11.64831895269265
1949,NE,M,10531,3838,14369,26.710279073004383
1949,NH,F,4386,586,4972,11.786001609010459
1949,NH,M,3649,1786,5435,32.861085556577734
1949,NJ,F,38145,4307,42452,10.145576180156413
1949,NJ,M,31017,14856,45873,32.385063109018375
1949,NM,F,7568,1095,8663,12.639963061295164
1949,NM,M,7411,2198,9609,22.874388594026435
1949,NV,F,991,125,1116,11.200716845878137
1949,NV,M,956,421,1377,30.57371096586783
1949,NY,F,127358,14540,141898,10.246796995024596
1949,NY,M,100160,49066,149226,32.88032916515889
1949,OH,F,75783,10917,86700,12.591695501730104
1949,OH,M,62523,28793,91316,31.53116649875159
1949,OK,F,18889,2616,21505,12.164612880725413
1949,OK,M,18205,5060,23265,21.749408983451538
1949,OR,F,13545,1484,15029,9.874243129948766
1949,OR,M,11822,4391,16213,27.083204835625736
1949,PA,F,90538,12176,102714,11.854274977120937
1949,PA,M,72698,35632,108330,32.89208898735346
1949,RI,F,6530,749,7279,10.289874982827312
1949,RI,M,5222,2799,8021,34.895898267049
1949,SC,F,24413,3408,27821,12.249739405485064
1949,SC,M,21046,7540,28586,26.376547960540126
1949,SD,F,6260,784,7044,11.130039750141965
1949,SD,M,5828,1922,7750,24.8
1949,TN,F,33318,4371,37689,11.597548356284328
1949,TN,M,29624,9460,39084,24.20427796540784
1949,TX,F,84602,10117,94719,10.681067156536702
1949,TX,M,78407,22169,100576,22.042037861915368
1949,UT,F,7580,649,8229,7.886742009964759
1949,UT,M,7559,2063,9622,21.440448971107877
1949,VA,F,31581,4159,35740,11.636821488528259
1949,VA,M,27649,9205,36854,24.976936017799968
1949,VT,F,3082,448,3530,12.691218130311615
1949,VT,M,2644,1238,3882,31.890777949510564
1949,WA,F,22667,2449,25116,9.750756489886925
1949,WA,M,19284,7496,26780,27.99103808812547
1949,WI,F,32224,4679,36903,12.679185974040049
1949,WI,M,26139,13020,39159,33.24906151842488
1949,WV,F,20447,3409,23856,14.289906103286384
1949,WV,M,18263,6704,24967,26.85144390595586
1949,WY,F,2247,300,2547,11.778563015312132
1949,WY,M,2189,806,2995,26.91151919866444
1950,AK,F,998,184,1182,15.5668358714044
1950,AK,M,888,491,1379,35.60551124002901
1950,AL,F,32317,4490,36807,12.198766538973564
1950,AL,M,29285,8806,38091,23.118321913312855
1950,AR,F,18848,2502,21350,11.718969555035128
1950,AR,M,17651,4632,22283,20.78714715253781
1950,AZ,F,7933,1088,9021,12.060747145549273
1950,AZ,M,7436,2545,9981,25.498447049393846
1950,CA,F,102225,11326,113551,9.974372748808905
1950,CA,M,87580,34476,122056,28.246050992986827
1950,CO,F,12791,1743,14534,11.99256914820421
1950,CO,M,11792,4570,16362,27.930570834861264
1950,CT,F,15372,2062,17434,11.827463576918666
1950,CT,M,11984,6624,18608,35.597592433361996
1950,DC,F,10291,1516,11807,12.83984077242314
1950,DC,M,8887,4243,13130,32.31530845392231
1950,DE,F,2564,458,3022,15.155526141628062
1950,DE,M,2285,1062,3347,31.729907379743054
1950,FL,F,25006,3288,28294,11.620838340284159
1950,FL,M,22527,7994,30521,26.191802365584348
1950,GA,F,36906,4971,41877,11.870477827924637
1950,GA,M,33404,10072,43476,23.16680467384304
1950,HI,F,4809,518,5327,9.724047306176084
1950,HI,M,4585,1290,5875,21.95744680851064
1950,IA,F,24421,3274,27695,11.821628452789312
1950,IA,M,21601,8468,30069,28.16189430975423
1950,ID,F,5486,583,6069,9.606195419344209
1950,ID,M,5274,1580,6854,23.05223227312518
1950,IL,F,76499,10488,86987,12.056974030602275
1950,IL,M,63847,29003,92850,31.2364028002154
1950,IN,F,36398,5473,41871,13.071099328891117
1950,IN,M,30950,13982,44932,31.11813406926022
1950,KS,F,15778,2169,17947,12.085585334596312
1950,KS,M,14651,5237,19888,26.33246178600161
1950,KY,F,29026,4524,33550,13.48435171385991
1950,KY,M,26651,9083,35734,25.418369060278728
1950,LA,F,30199,3802,34001,11.182024058115937
1950,LA,M,27450,8008,35458,22.584466128941283
1950,MA,F,39100,5046,44146,11.430254156661986
1950,MA,M,29635,17869,47504,37.61577972381273
1950,MD,F,19603,3211,22814,14.074690979223284
1950,MD,M,17136,7285,24421,29.830883256213912
1950,ME,F,7860,1052,8912,11.804308797127469
1950,ME,M,6500,2861,9361,30.56297404123491
1950,MI,F,64456,8751,73207,11.953774912235168
1950,MI,M,53768,23988,77756,30.850352384381914
1950,MN,F,29119,4048,33167,12.204902463291827
1950,MN,M,24500,11136,35636,31.24929846222921
1950,MO,F,33962,5398,39360,13.714430894308943
1950,MO,M,29727,11933,41660,28.64378300528084
1950,MS,F,24983,3367,28350,11.876543209876543
1950,MS,M,22881,6240,29121,21.42783558256928
1950,MT,F,5223,690,5913,11.669203450025368
1950,MT,M,4910,1909,6819,27.995307229799092
1950,NC,F,42705,5594,48299,11.582020331683886
1950,NC,M,38551,11700,50251,23.283118743905593
1950,ND,F,5998,801,6799,11.781144285924402
1950,ND,M,5703,1715,7418,23.119439201941226
1950,NE,F,11651,1601,13252,12.081195291276789
1950,NE,M,10792,4030,14822,27.189313183106194
1950,NH,F,4310,519,4829,10.747566784013253
1950,NH,M,3573,1703,5276,32.27824109173616
1950,NJ,F,38590,4438,43028,10.314214000185926
1950,NJ,M,30855,15152,46007,32.93411872106419
1950,NM,F,7864,1183,9047,13.076157842378688
1950,NM,M,7547,2350,9897,23.744569061331717
1950,NV,F,960,135,1095,12.32876712328767
1950,NV,M,911,490,1401,34.97501784439686
1950,NY,F,128134,14689,142823,10.284758057175665
1950,NY,M,101059,49869,150928,33.041582741439626
1950,OH,F,74003,11120,85123,13.063449361512165
1950,OH,M,62200,28597,90797,31.495533993413876
1950,OK,F,18971,2682,21653,12.386274419249064
1950,OK,M,18420,5379,23799,22.601789991176098
1950,OR,F,13536,1567,15103,10.375422101569225
1950,OR,M,12222,4580,16802,27.25865968337103
1950,PA,F,90078,12190,102268,11.919662064379864
1950,PA,M,72446,36034,108480,33.217182890855455
1950,RI,F,6463,833,7296,11.417214912280702
1950,RI,M,5114,2889,8003,36.09896288891666
1950,SC,F,24258,3357,27615,12.156436719174362
1950,SC,M,21266,7308,28574,25.575698187163155
1950,SD,F,6378,837,7215,11.6008316008316
1950,SD,M,5958,2105,8063,26.10690809872256
1950,TN,F,32314,4388,36702,11.955751730150945
1950,TN,M,29749,9469,39218,24.144525472997096
1950,TX,F,85150,10565,95715,11.037977328527399
1950,TX,M,80528,23384,103912,22.503656940488106
1950,UT,F,7802,714,8516,8.3842179426961
1950,UT,M,7398,2216,9614,23.049719159558975
1950,VA,F,30704,4271,34975,12.211579699785561
1950,VA,M,27596,9463,37059,25.534957770042364
1950,VT,F,2999,471,3470,13.573487031700287
1950,VT,M,2550,1263,3813,33.123524783634934
1950,WA,F,22169,2554,24723,10.33046151357036
1950,WA,M,19467,7620,27087,28.131576032783258
1950,WI,F,32178,4661,36839,12.652352126822116
1950,WI,M,25840,13284,39124,33.953583478171964
1950,WV,F,19619,3282,22901,14.331251910396926
1950,WV,M,17753,6572,24325,27.017471736896198
1950,WY,F,2333,313,2646,11.829176114890402
1950,WY,M,2142,846,2988,28.313253012048197
1951,AK,F,1115,206,1321,15.594246782740347
1951,AK,M,1149,586,1735,33.77521613832853
1951,AL,F,31968,4529,36497,12.409239115543743
1951,AL,M,29708,8967,38675,23.18552036199095
1951,AR,F,18055,2548,20603,12.367131000339757
1951,AR,M,17206,4781,21987,21.74466730340656
1951,AZ,F,8553,1207,9760,12.366803278688526
1951,AZ,M,7798,2787,10585,26.329711856400568
1951,CA,F,108715,12174,120889,10.070395155886805
1951,CA,M,92564,36878,129442,28.489980068293136
1951,CO,F,13740,1855,15595,11.894838089131133
1951,CO,M,12101,4976,17077,29.13860748375007
1951,CT,F,16187,2228,18415,12.098832473527017
1951,CT,M,12864,7406,20270,36.53675382338431
1951,DC,F,10982,1719,12701,13.534367372647823
1951,DC,M,9372,4489,13861,32.38583074814227
1951,DE,F,2691,467,3158,14.787840405319821
1951,DE,M,2450,1216,3666,33.1696672122204
1951,FL,F,27046,3791,30837,12.293673184810455
1951,FL,M,24387,8739,33126,26.381090382177142
1951,GA,F,37696,5184,42880,12.08955223880597
1951,GA,M,34456,10445,44901,23.262288145030176
1951,HI,F,4763,461,5224,8.824655436447166
1951,HI,M,4785,1390,6175,22.51012145748988
1951,IA,F,25954,3487,29441,11.844027037125098
1951,IA,M,22488,9051,31539,28.697802720441356
1951,ID,F,5632,583,6215,9.380530973451327
1951,ID,M,5283,1700,6983,24.344837462408705
1951,IL,F,80929,10943,91872,11.911137234413097
1951,IL,M,67098,30223,97321,31.054962443871315
1951,IN,F,39440,5900,45340,13.01279223643582
1951,IN,M,33551,15032,48583,30.94086408826133
1951,KS,F,17142,2381,19523,12.195871536136863
1951,KS,M,15728,5648,21376,26.422155688622755
1951,KY,F,29256,4644,33900,13.699115044247787
1951,KY,M,27285,9429,36714,25.682301029579996
1951,LA,F,31359,4032,35391,11.392726964482495
1951,LA,M,28622,8527,37149,22.95351153463081
1951,MA,F,40976,5355,46331,11.55813602123848
1951,MA,M,30385,19032,49417,38.513062306493715
1951,MD,F,21195,3500,24695,14.172909495849362
1951,MD,M,18636,7880,26516,29.71790616985971
1951,ME,F,7751,1052,8803,11.950471430194252
1951,ME,M,6521,3006,9527,31.55242993597145
1951,MI,F,69078,9380,78458,11.955441127737133
1951,MI,M,58278,25934,84212,30.7960860684938
1951,MN,F,31315,4357,35672,12.214061448755325
1951,MN,M,25823,11923,37746,31.58745297514968
1951,MO,F,35508,5630,41138,13.685643444017698
1951,MO,M,31563,12663,44226,28.63247863247863
1951,MS,F,25169,3403,28572,11.910261794764104
1951,MS,M,22901,6252,29153,21.44547730936782
1951,MT,F,5448,656,6104,10.747051114023591
1951,MT,M,4890,1981,6871,28.831320040750985
1951,NC,F,44306,6197,50503,12.270558184662297
1951,NC,M,40258,12565,52823,23.78698672926566
1951,ND,F,6166,793,6959,11.395315418882024
1951,ND,M,5696,1888,7584,24.894514767932492
1951,NE,F,12638,1639,14277,11.480002801709043
1951,NE,M,11125,4273,15398,27.750357189245356
1951,NH,F,4512,561,5073,11.058545239503252
1951,NH,M,3765,1734,5499,31.533006001091106
1951,NJ,F,41374,4941,46315,10.668250026989098
1951,NJ,M,33227,16256,49483,32.8516864377665
1951,NM,F,8339,1211,9550,12.68062827225131
1951,NM,M,7732,2520,10252,24.580569644947328
1951,NV,F,1084,152,1236,12.297734627831716
1951,NV,M,1027,539,1566,34.41890166028097
1951,NY,F,134288,15345,149633,10.25509078879659
1951,NY,M,105166,52938,158104,33.483023832414105
1951,OH,F,79172,12148,91320,13.302671922908454
1951,OH,M,67246,30445,97691,31.164590392154857
1951,OK,F,18907,2664,21571,12.34991423670669
1951,OK,M,18480,5614,24094,23.300406740267288
1951,OR,F,14148,1597,15745,10.14290250873293
1951,OR,M,12336,4827,17163,28.124453766823983
1951,PA,F,95034,13399,108433,12.356939308144199
1951,PA,M,76898,38111,115009,33.13740663774139
1951,RI,F,6956,936,7892,11.860111505321845
1951,RI,M,5410,2980,8390,35.518474374255064
1951,SC,F,24735,3672,28407,12.926391382405743
1951,SC,M,21785,7555,29340,25.749829584185413
1951,SD,F,6739,821,7560,10.859788359788359
1951,SD,M,6098,2026,8124,24.938453963564747
1951,TN,F,33116,4786,37902,12.62730198934093
1951,TN,M,30145,9676,39821,24.29873684739208
1951,TX,F,90346,11571,101917,11.353356162367417
1951,TX,M,84074,25162,109236,23.034530740781427
1951,UT,F,8537,689,9226,7.468025146325602
1951,UT,M,8197,2441,10638,22.946042489189697
1951,VA,F,32954,4500,37454,12.014738078709884
1951,VA,M,29129,10080,39209,25.70838327934913
1951,VT,F,3055,501,3556,14.088863892013498
1951,VT,M,2594,1262,3856,32.72821576763486
1951,WA,F,23310,2484,25794,9.630146545708303
1951,WA,M,19996,8044,28040,28.687589158345222
1951,WI,F,34220,5089,39309,12.946144648808161
1951,WI,M,27873,14334,42207,33.96119127159002
1951,WV,F,19478,3448,22926,15.039692925063248
1951,WV,M,17697,6630,24327,27.253668763102723
1951,WY,F,2436,337,2773,12.152902993148215
1951,WY,M,2351,985,3336,29.526378896882495
1952,AK,F,1585,244,1829,13.340623291416073
1952,AK,M,1553,794,2347,33.830421815083085
1952,AL,F,32175,4675,36850,12.686567164179104
1952,AL,M,29758,9164,38922,23.544524947330558
1952,AR,F,17461,2475,19936,12.41472712680578
1952,AR,M,16564,4899,21463,22.825327307459347
1952,AZ,F,9163,1291,10454,12.34933996556342
1952,AZ,M,8739,3113,11852,26.265609179885253
1952,CA,F,118129,13221,131350,10.065473924628854
1952,CA,M,99614,40747,140361,29.030143700885574
1952,CO,F,14363,1884,16247,11.595986951437188
1952,CO,M,12758,5235,17993,29.094647918635026
1952,CT,F,17818,2419,20237,11.9533527696793
1952,CT,M,13635,8045,21680,37.10793357933579
1952,DC,F,11375,1675,13050,12.835249042145595
1952,DC,M,9637,4778,14415,33.14602844259452
1952,DE,F,2984,489,3473,14.08004606968039
1952,DE,M,2508,1314,3822,34.37990580847723
1952,FL,F,28749,3988,32737,12.181934813819225
1952,FL,M,25835,9706,35541,27.30930474663065
1952,GA,F,38497,5578,44075,12.655700510493478
1952,GA,M,35499,11250,46749,24.064685875633703
1952,HI,F,5350,519,5869,8.843073777474867
1952,HI,M,5220,1484,6704,22.136038186157517
1952,IA,F,25201,3233,28434,11.37019061686713
1952,IA,M,21963,8891,30854,28.816360925649835
1952,ID,F,5747,556,6303,8.821196255751229
1952,ID,M,5403,1830,7233,25.300705101617588
1952,IL,F,82693,11301,93994,12.02310785794838
1952,IL,M,68831,31863,100694,31.643394839811705
1952,IN,F,40637,5941,46578,12.754948688221907
1952,IN,M,34851,15543,50394,30.84295749493987
1952,KS,F,18111,2485,20596,12.065449601864438
1952,KS,M,16448,6101,22549,27.056632223158456
1952,KY,F,28879,4823,33702,14.310723399204795
1952,KY,M,26453,9255,35708,25.918561666853368
1952,LA,F,31550,4015,35565,11.28918880922255
1952,LA,M,28768,8854,37622,23.53410238690128
1952,MA,F,42725,5605,48330,11.597351541485619
1952,MA,M,31336,20283,51619,39.29367093512079
1952,MD,F,22295,3762,26057,14.43757915339448
1952,MD,M,19202,8432,27634,30.513135991894043
1952,ME,F,7892,1053,8945,11.771939631078816
1952,ME,M,6678,3214,9892,32.49090173877881
1952,MI,F,71299,9514,80813,11.77285832724933
1952,MI,M,59774,26861,86635,31.00479021180816
1952,MN,F,31228,4050,35278,11.480242644140825
1952,MN,M,25683,12029,37712,31.897008909630888
1952,MO,F,35598,5738,41336,13.881362492742404
1952,MO,M,31397,13000,44397,29.28125774264027
1952,MS,F,24825,3380,28205,11.983690834958342
1952,MS,M,22587,6287,28874,21.77391424811249
1952,MT,F,5674,723,6397,11.30217289354385
1952,MT,M,5084,2070,7154,28.934861615879225
1952,NC,F,44919,6173,51092,12.08212636029124
1952,NC,M,40335,12978,53313,24.34303078048506
1952,ND,F,6061,821,6882,11.929671607090961
1952,ND,M,5804,1823,7627,23.90192736331454
1952,NE,F,12820,1625,14445,11.24956732433368
1952,NE,M,11080,4500,15580,28.88318356867779
1952,NH,F,4396,575,4971,11.567089116877892
1952,NH,M,3753,1869,5622,33.24439701173959
1952,NJ,F,43348,5266,48614,10.832270539350803
1952,NJ,M,34660,17258,51918,33.24087984899264
1952,NM,F,8730,1269,9999,12.69126912691269
1952,NM,M,8215,2859,11074,25.817229546685933
1952,NV,F,1156,191,1347,14.179658500371195
1952,NV,M,1118,576,1694,34.002361275088546
1952,NY,F,137940,16464,154404,10.662936193362867
1952,NY,M,110029,54845,164874,33.26479614736101
1952,OH,F,82641,12352,94993,13.003063383617741
1952,OH,M,69059,32450,101509,31.967608783457624
1952,OK,F,18750,2733,21483,12.721686915235303
1952,OK,M,18259,5807,24066,24.129477270838528
1952,OR,F,14993,1603,16596,9.658953964810797
1952,OR,M,13150,5380,18530,29.033998920669184
1952,PA,F,97407,13656,111063,12.295724048513005
1952,PA,M,78285,39597,117882,33.590370031047996
1952,RI,F,7208,982,8190,11.99023199023199
1952,RI,M,5586,3256,8842,36.824247907713186
1952,SC,F,25548,3769,29317,12.856022103216564
1952,SC,M,22409,7700,30109,25.573748713009397
1952,SD,F,6638,787,7425,10.599326599326599
1952,SD,M,6114,2225,8339,26.68185633769037
1952,TN,F,32160,4912,37072,13.249892101855847
1952,TN,M,29718,9712,39430,24.630991630738016
1952,TX,F,94138,12442,106580,11.673860011259148
1952,TX,M,87860,27307,115167,23.71078520756814
1952,UT,F,8888,703,9591,7.3297883432384525
1952,UT,M,8456,2595,11051,23.482037824631256
1952,VA,F,33859,4850,38709,12.529385930920458
1952,VA,M,30328,10800,41128,26.25948259093562
1952,VT,F,3114,494,3608,13.691796008869181
1952,VT,M,2596,1304,3900,33.43589743589744
1952,WA,F,24574,2822,27396,10.300773835596438
1952,WA,M,21205,8686,29891,29.058914054397643
1952,WI,F,35008,5066,40074,12.641613015920546
1952,WI,M,27734,14741,42475,34.7051206592113
1952,WV,F,18878,3341,22219,15.036680318646203
1952,WV,M,17154,6600,23754,27.784794139934327
1952,WY,F,2600,330,2930,11.262798634812286
1952,WY,M,2341,1091,3432,31.789044289044288
1953,AK,F,1978,298,2276,13.093145869947275
1953,AK,M,1755,956,2711,35.263740317226116
1953,AL,F,31854,4486,36340,12.344523940561364
1953,AL,M,29323,9275,38598,24.0297424737033
1953,AR,F,17001,2418,19419,12.451722539780627
1953,AR,M,16226,4690,20916,22.42302543507363
1953,AZ,F,9802,1346,11148,12.073914603516325
1953,AZ,M,8955,3393,12348,27.478134110787174
1953,CA,F,124913,13876,138789,9.997910497229608
1953,CA,M,105043,43381,148424,29.227752924055412
1953,CO,F,14832,1868,16700,11.18562874251497
1953,CO,M,12970,5324,18294,29.10243795780037
1953,CT,F,18306,2493,20799,11.986153180441367
1953,CT,M,14057,8475,22532,37.613172377063734
1953,DC,F,11300,1677,12977,12.922863527779919
1953,DC,M,9664,4688,14352,32.6644370122631
1953,DE,F,3092,550,3642,15.101592531576058
1953,DE,M,2664,1402,4066,34.48106246925725
1953,FL,F,31594,4130,35724,11.56085544731833
1953,FL,M,27621,10643,38264,27.81465607359398
1953,GA,F,39199,5329,44528,11.967750628817821
1953,GA,M,35838,10983,46821,23.457422951239828
1953,HI,F,5460,508,5968,8.512064343163539
1953,HI,M,5248,1619,6867,23.5765254113878
1953,IA,F,24969,3090,28059,11.012509355287074
1953,IA,M,21189,8824,30013,29.400593076333585
1953,ID,F,5684,597,6281,9.50485591466327
1953,ID,M,5490,1821,7311,24.907673368896184
1953,IL,F,83381,11038,94419,11.690443660703883
1953,IL,M,69347,31753,101100,31.407517309594464
1953,IN,F,41201,5754,46955,12.254286018528378
1953,IN,M,35249,15451,50700,30.47534516765286
1953,KS,F,19015,2378,21393,11.115785537325293
1953,KS,M,17066,6137,23203,26.449166056113434
1953,KY,F,28108,4737,32845,14.422286497183743
1953,KY,M,26190,9220,35410,26.037842417396217
1953,LA,F,33002,4033,37035,10.88969893344134
1953,LA,M,29919,9344,39263,23.798487125283348
1953,MA,F,42702,5520,48222,11.447057359711335
1953,MA,M,31096,20608,51704,39.8576512455516
1953,MD,F,23086,3734,26820,13.922445935868755
1953,MD,M,19617,8797,28414,30.960090096431337
1953,ME,F,8215,1044,9259,11.275515714440004
1953,ME,M,6553,3118,9671,32.240719677386
1953,MI,F,73156,9802,82958,11.815617541406494
1953,MI,M,61299,27779,89078,31.185028851119245
1953,MN,F,31405,3956,35361,11.187466417804927
1953,MN,M,25673,12125,37798,32.078416847452246
1953,MO,F,36352,5526,41878,13.195472563159655
1953,MO,M,32187,13057,45244,28.859075236495446
1953,MS,F,24403,3419,27822,12.288836172812882
1953,MS,M,22465,6390,28855,22.14520880263386
1953,MT,F,5683,670,6353,10.54619864630883
1953,MT,M,5153,2123,7276,29.17811984606927
1953,NC,F,45201,6075,51276,11.847648022466652
1953,NC,M,40892,13154,54046,24.338526440439626
1953,ND,F,6157,779,6936,11.231257208765859
1953,ND,M,5648,1854,7502,24.71340975739803
1953,NE,F,12348,1516,13864,10.934795152914022
1953,NE,M,10863,4263,15126,28.183260610868704
1953,NH,F,4310,575,4885,11.770726714431934
1953,NH,M,3441,1875,5316,35.270880361173816
1953,NJ,F,44490,5419,49909,10.85776112524795
1953,NJ,M,34854,18087,52941,34.16444721482405
1953,NM,F,9056,1239,10295,12.034968431277319
1953,NM,M,8488,2909,11397,25.52426077037817
1953,NV,F,1337,194,1531,12.671456564337035
1953,NV,M,1307,686,1993,34.42047165077772
1953,NY,F,137577,16169,153746,10.516696369336438
1953,NY,M,108801,55226,164027,33.668847201985045
1953,OH,F,84364,12014,96378,12.465500425408289
1953,OH,M,70983,32097,103080,31.137951105937134
1953,OK,F,19458,2566,22024,11.650926262259354
1953,OK,M,18624,5924,24548,24.13231220466026
1953,OR,F,14971,1631,16602,9.824117576195638
1953,OR,M,13236,5397,18633,28.96473997745935
1953,PA,F,97318,13332,110650,12.048802530501582
1953,PA,M,77655,39646,117301,33.79851834170211
1953,RI,F,7268,1021,8289,12.317529255640004
1953,RI,M,5565,3352,8917,37.5911180890434
1953,SC,F,25267,3548,28815,12.313031407253167
1953,SC,M,22680,7822,30502,25.64422005114419
1953,SD,F,6595,775,7370,10.515603799185888
1953,SD,M,5987,2075,8062,25.73803026544282
1953,TN,F,32958,4834,37792,12.791066892464015
1953,TN,M,29571,10137,39708,25.528860682985798
1953,TX,F,98316,12460,110776,11.247923737993789
1953,TX,M,90288,28424,118712,23.943661971830984
1953,UT,F,9089,713,9802,7.2740257090389715
1953,UT,M,8669,2683,11352,23.63460183227625
1953,VA,F,34489,5010,39499,12.683865414314285
1953,VA,M,30914,11308,42222,26.782246222348537
1953,VT,F,3095,505,3600,14.027777777777779
1953,VT,M,2419,1425,3844,37.070759625390224
1953,WA,F,24698,2724,27422,9.933629932171248
1953,WA,M,21205,8725,29930,29.15135315736719
1953,WI,F,35136,4742,39878,11.891268368523997
1953,WI,M,27934,14366,42300,33.96217494089834
1953,WV,F,17783,3032,20815,14.566418448234447
1953,WV,M,16296,6223,22519,27.63444202673298
1953,WY,F,2740,369,3109,11.868768092634289
1953,WY,M,2587,1059,3646,29.04552934722984
1954,AK,F,2159,303,2462,12.307067424857838
1954,AK,M,1961,1018,2979,34.1725411211816
1954,AL,F,32380,4328,36708,11.790345428789365
1954,AL,M,29526,9221,38747,23.797971455854647
1954,AR,F,17004,2318,19322,11.996687713487217
1954,AR,M,16294,4689,20983,22.34666158318639
1954,AZ,F,10361,1406,11767,11.948670009348177
1954,AZ,M,9496,3423,12919,26.495858812601597
1954,CA,F,129621,13852,143473,9.654778250960112
1954,CA,M,108492,45040,153532,29.33590391579606
1954,CO,F,15472,1877,17349,10.819067381405269
1954,CO,M,13350,5598,18948,29.54401519949335
1954,CT,F,19140,2527,21667,11.66289749388471
1954,CT,M,14789,8893,23682,37.55172705008023
1954,DC,F,11482,1738,13220,13.146747352496218
1954,DC,M,9859,4753,14612,32.528059129482614
1954,DE,F,3374,548,3922,13.972463029066803
1954,DE,M,2687,1558,4245,36.7020023557126
1954,FL,F,33272,4369,37641,11.607024255466115
1954,FL,M,29760,11169,40929,27.288719489848273
1954,GA,F,40565,5374,45939,11.698121421885544
1954,GA,M,36944,11547,48491,23.812666267967252
1954,HI,F,5459,454,5913,7.677997632335531
1954,HI,M,5257,1625,6882,23.61232199941877
1954,IA,F,24763,3000,27763,10.805748658286209
1954,IA,M,21851,8923,30774,28.99525573536102
1954,ID,F,5887,534,6421,8.316461610341069
1954,ID,M,5577,1838,7415,24.787592717464598
1954,IL,F,87844,11827,99671,11.866039269195653
1954,IL,M,72456,33682,106138,31.734157417701482
1954,IN,F,43153,5683,48836,11.636907199606847
1954,IN,M,36480,15962,52442,30.43743564318676
1954,KS,F,19744,2220,21964,10.107448552176288
1954,KS,M,17794,6491,24285,26.728433189211447
1954,KY,F,29433,4701,34134,13.772191949375989
1954,KY,M,27094,9766,36860,26.494845360824744
1954,LA,F,34014,4104,38118,10.766566976231703
1954,LA,M,30741,9542,40283,23.687411563190427
1954,MA,F,43961,5938,49899,11.900038076915369
1954,MA,M,31710,21615,53325,40.53445850914205
1954,MD,F,24124,4040,28164,14.344553330492829
1954,MD,M,20722,9402,30124,31.21099455583588
1954,ME,F,8438,1030,9468,10.878749471905365
1954,ME,M,6898,3388,10286,32.93797394516819
1954,MI,F,77462,10189,87651,11.62451084414325
1954,MI,M,64401,29142,93543,31.15358712036176
1954,MN,F,31943,4011,35954,11.155921455192747
1954,MN,M,26408,12451,38859,32.04148331145938
1954,MO,F,37722,5677,43399,13.08094656558907
1954,MO,M,33063,13688,46751,29.278518106564565
1954,MS,F,24834,3352,28186,11.892428865394166
1954,MS,M,22942,6362,29304,21.71034671034671
1954,MT,F,6161,681,6842,9.953230049693072
1954,MT,M,5230,2259,7489,30.16424088663373
1954,NC,F,45592,6053,51645,11.720398876948398
1954,NC,M,41871,13204,55075,23.97458011802088
1954,ND,F,6379,759,7138,10.633230596805827
1954,ND,M,5742,1970,7712,25.54460580912863
1954,NE,F,12933,1499,14432,10.386640798226164
1954,NE,M,10938,4464,15402,28.98324892871056
1954,NH,F,4587,549,5136,10.689252336448599
1954,NH,M,3663,1993,5656,35.23691654879774
1954,NJ,F,46785,5873,52658,11.1531011432261
1954,NJ,M,36891,19249,56140,34.28749554684717
1954,NM,F,9325,1343,10668,12.589051368578927
1954,NM,M,8582,3024,11606,26.05548854041013
1954,NV,F,1674,167,1841,9.071156979902227
1954,NV,M,1530,730,2260,32.30088495575221
1954,NY,F,143172,17185,160357,10.716713333374907
1954,NY,M,112282,57656,169938,33.92766773764549
1954,OH,F,89553,12412,101965,12.172804393664492
1954,OH,M,74780,34418,109198,31.518892287404533
1954,OK,F,20080,2458,22538,10.906025379359304
1954,OK,M,18587,6176,24763,24.940435326899003
1954,OR,F,14617,1451,16068,9.030370923574807
1954,OR,M,12780,5284,18064,29.25155004428698
1954,PA,F,99148,13845,112993,12.252971423008505
1954,PA,M,79531,40954,120485,33.99095323069262
1954,RI,F,7503,1058,8561,12.358369349375073
1954,RI,M,5619,3542,9161,38.66390132081651
1954,SC,F,25806,3578,29384,12.176694799891097
1954,SC,M,23514,7847,31361,25.02152354835624
1954,SD,F,6611,738,7349,10.042182609878896
1954,SD,M,5993,2179,8172,26.66421928536466
1954,TN,F,33994,4728,38722,12.210113113992046
1954,TN,M,31121,10473,41594,25.179112371976725
1954,TX,F,99665,12339,112004,11.01657083675583
1954,TX,M,91688,29459,121147,24.31673916811807
1954,UT,F,9286,703,9989,7.037741515667234
1954,UT,M,8641,2730,11371,24.00844252924105
1954,VA,F,35622,5130,40752,12.588339222614842
1954,VA,M,32027,11758,43785,26.85394541509649
1954,VT,F,3041,534,3575,14.937062937062937
1954,VT,M,2612,1380,3992,34.569138276553105
1954,WA,F,25888,2601,28489,9.129839587209098
1954,WA,M,21822,9068,30890,29.355778569116218
1954,WI,F,36635,5000,41635,12.009126936471718
1954,WI,M,28933,15263,44196,34.534799529369174
1954,WV,F,18003,2954,20957,14.095528940210908
1954,WV,M,16287,6277,22564,27.818649175678072
1954,WY,F,2845,336,3181,10.562716127004085
1954,WY,M,2464,1120,3584,31.25
1955,AK,F,2271,306,2577,11.874272409778813
1955,AK,M,2036,1064,3100,34.32258064516129
1955,AL,F,32074,4153,36227,11.463825323653628
1955,AL,M,29613,9281,38894,23.862292384429477
1955,AR,F,16563,2138,18701,11.43254371423988
1955,AR,M,15538,4506,20044,22.48054280582718
1955,AZ,F,10665,1352,12017,11.250728135141882
1955,AZ,M,9775,3681,13456,27.355826397146256
1955,CA,F,133104,13003,146107,8.89964204316015
1955,CA,M,111551,46785,158336,29.54792340339531
1955,CO,F,16124,1764,17888,9.861359570661895
1955,CO,M,13688,5873,19561,30.024027401462096
1955,CT,F,20381,2593,22974,11.286671889962568
1955,CT,M,14933,9233,24166,38.20657121575768
1955,DC,F,11599,1653,13252,12.473588892242681
1955,DC,M,10201,4736,14937,31.706500636004552
1955,DE,F,3593,580,4173,13.898873711957824
1955,DE,M,3034,1717,4751,36.139760050515676
1955,FL,F,35221,4389,39610,11.080535218379199
1955,FL,M,31224,11845,43069,27.502379902017694
1955,GA,F,40814,5192,46006,11.285484502021475
1955,GA,M,37216,11840,49056,24.135681669928243
1955,HI,F,5647,406,6053,6.707417809350735
1955,HI,M,5190,1733,6923,25.032500361115122
1955,IA,F,25639,2796,28435,9.832952347459118
1955,IA,M,21758,9052,30810,29.38007140538786
1955,ID,F,5847,520,6367,8.167111669546097
1955,ID,M,5710,1866,7576,24.63041182682154
1955,IL,F,89449,11272,100721,11.191310650211971
1955,IL,M,72731,35103,107834,32.55281265649053
1955,IN,F,42920,5305,48225,11.00051840331778
1955,IN,M,36774,16175,52949,30.548263423294113
1955,KS,F,19465,2231,21696,10.283001474926253
1955,KS,M,17652,6477,24129,26.8432177048365
1955,KY,F,29058,4566,33624,13.57958600999286
1955,KY,M,26779,9711,36490,26.612770622088245
1955,LA,F,33819,3741,37560,9.960063897763579
1955,LA,M,30998,9661,40659,23.76103691679579
1955,MA,F,45487,5887,51374,11.45910382683848
1955,MA,M,31977,22505,54482,41.30722073345325
1955,MD,F,24742,3984,28726,13.86896887836803
1955,MD,M,20884,9633,30517,31.56601238653865
1955,ME,F,8425,1025,9450,10.846560846560847
1955,ME,M,6579,3542,10121,34.99654184369134
1955,MI,F,79718,9753,89471,10.90073878686949
1955,MI,M,65595,30199,95794,31.524938931457086
1955,MN,F,32598,3792,36390,10.420445177246496
1955,MN,M,26190,12886,39076,32.97676323062749
1955,MO,F,38119,5400,43519,12.408373354167146
1955,MO,M,33101,13831,46932,29.47029745163215
1955,MS,F,24411,3108,27519,11.294015044151314
1955,MS,M,22499,6445,28944,22.2671365395246
1955,MT,F,6194,654,6848,9.550233644859812
1955,MT,M,5427,2303,7730,29.79301423027167
1955,NC,F,45976,5992,51968,11.530172413793103
1955,NC,M,41669,13080,54749,23.890847321412263
1955,ND,F,6358,599,6957,8.61003306022711
1955,ND,M,5864,1847,7711,23.952794708857475
1955,NE,F,13267,1374,14641,9.384604876716072
1955,NE,M,11290,4670,15960,29.260651629072683
1955,NH,F,4597,519,5116,10.144644253322909
1955,NH,M,3659,2097,5756,36.43154968728283
1955,NJ,F,47824,5788,53612,10.796090427516228
1955,NJ,M,37361,20120,57481,35.002870513734976
1955,NM,F,9567,1203,10770,11.16991643454039
1955,NM,M,8702,3052,11754,25.965628722137147
1955,NV,F,1747,208,1955,10.639386189258312
1955,NV,M,1586,765,2351,32.539344959591666
1955,NY,F,146403,16885,163288,10.34062515310372
1955,NY,M,114397,59704,174101,34.29273812327327
1955,OH,F,89979,12001,101980,11.767993724259659
1955,OH,M,75265,34901,110166,31.68037325490623
1955,OK,F,19798,2261,22059,10.249784668389319
1955,OK,M,18351,6054,24405,24.80639213275968
1955,OR,F,14918,1346,16264,8.275946876537137
1955,OR,M,12718,5230,17948,29.139737018052152
1955,PA,F,99434,13295,112729,11.79377090189747
1955,PA,M,78489,41880,120369,34.79301148966927
1955,RI,F,7447,980,8427,11.629286816186069
1955,RI,M,5461,3684,9145,40.2843083652269
1955,SC,F,25301,3325,28626,11.615314748829734
1955,SC,M,22827,7650,30477,25.100895757456442
1955,SD,F,6915,746,7661,9.737632162903015
1955,SD,M,6164,2236,8400,26.61904761904762
1955,TN,F,33926,4487,38413,11.680941347981152
1955,TN,M,30669,10406,41075,25.33414485696896
1955,TX,F,100313,11590,111903,10.357184347157807
1955,TX,M,91590,29291,120881,24.231268768458236
1955,UT,F,9609,620,10229,6.061198553133249
1955,UT,M,8918,2741,11659,23.509734968693714
1955,VA,F,36094,4837,40931,11.817448877379004
1955,VA,M,31638,11725,43363,27.039180868482347
1955,VT,F,3188,456,3644,12.513721185510429
1955,VT,M,2593,1432,4025,35.577639751552795
1955,WA,F,25617,2389,28006,8.530314932514461
1955,WA,M,21839,9216,31055,29.676380615037836
1955,WI,F,37073,4594,41667,11.025511795905633
1955,WI,M,29259,15470,44729,34.58606273334973
1955,WV,F,17001,2654,19655,13.502925464258459
1955,WV,M,15424,6114,21538,28.387036865075682
1955,WY,F,2728,294,3022,9.728656518861682
1955,WY,M,2415,1077,3492,30.84192439862543
1956,AK,F,2405,310,2715,11.41804788213628
1956,AK,M,2116,1037,3153,32.889311766571524
1956,AL,F,32608,4068,36676,11.091722107100011
1956,AL,M,30643,9313,39956,23.308138952848132
1956,AR,F,16780,2108,18888,11.160525201185937
1956,AR,M,15796,4528,20324,22.279078921472152
1956,AZ,F,11549,1357,12906,10.514489384782271
1956,AZ,M,10331,3815,14146,26.968754418210096
1956,CA,F,143056,13361,156417,8.541910406157898
1956,CA,M,119024,48652,167676,29.01548223955724
1956,CO,F,16910,1835,18745,9.78927714057082
1956,CO,M,14459,5908,20367,29.007708548141604
1956,CT,F,20991,2541,23532,10.798062213156554
1956,CT,M,15419,9269,24688,37.54455605962411
1956,DC,F,11870,1647,13517,12.184656358659465
1956,DC,M,10124,4849,14973,32.384959593935754
1956,DE,F,3866,591,4457,13.260040385909805
1956,DE,M,3196,1797,4993,35.99038654115762
1956,FL,F,38255,4719,42974,10.981058314329594
1956,FL,M,34313,12837,47150,27.22587486744433
1956,GA,F,41772,4960,46732,10.613712231447401
1956,GA,M,38218,11907,50125,23.754613466334167
1956,HI,F,5807,478,6285,7.60540970564837
1956,HI,M,5490,1878,7368,25.4885993485342
1956,IA,F,25693,2587,28280,9.147807637906649
1956,IA,M,21854,8824,30678,28.763283134493772
1956,ID,F,5806,466,6272,7.42984693877551
1956,ID,M,5567,1670,7237,23.075860163050987
1956,IL,F,93874,11087,104961,10.562971008279264
1956,IL,M,76393,35858,112251,31.944481563638632
1956,IN,F,45180,5314,50494,10.524022656157166
1956,IN,M,38832,16432,55264,29.73364215402432
1956,KS,F,19946,2099,22045,9.521433431617146
1956,KS,M,18281,6476,24757,26.158258270388174
1956,KY,F,29235,4296,33531,12.812024693567148
1956,KY,M,26767,9556,36323,26.308399636593894
1956,LA,F,35556,3799,39355,9.65315715919197
1956,LA,M,32262,9963,42225,23.595026642984017
1956,MA,F,46139,5695,51834,10.986996951807694
1956,MA,M,32546,23085,55631,41.496647552623536
1956,MD,F,25554,3915,29469,13.285147103736131
1956,MD,M,21574,9989,31563,31.64781548015081
1956,ME,F,8697,984,9681,10.164239231484352
1956,ME,M,6927,3442,10369,33.19510078117466
1956,MI,F,84544,9439,93983,10.043305704223105
1956,MI,M,69206,30837,100043,30.823745789310596
1956,MN,F,33366,3692,37058,9.962761077230288
1956,MN,M,26988,12931,39919,32.39309601943937
1956,MO,F,39554,5238,44792,11.694052509376675
1956,MO,M,34081,14066,48147,29.21469665815108
1956,MS,F,23781,3016,26797,11.254991230361608
1956,MS,M,22246,6252,28498,21.9383816408169
1956,MT,F,6249,615,6864,8.95979020979021
1956,MT,M,5627,2257,7884,28.62760020294267
1956,NC,F,45943,5816,51759,11.236693135493345
1956,NC,M,42195,13286,55481,23.946936789171065
1956,ND,F,6100,632,6732,9.38799762329174
1956,ND,M,5548,1873,7421,25.239186093518395
1956,NE,F,13035,1426,14461,9.861005462969366
1956,NE,M,11299,4728,16027,29.500218381481254
1956,NH,F,4794,561,5355,10.476190476190476
1956,NH,M,3779,2120,5899,35.938294626207835
1956,NJ,F,49416,5694,55110,10.332063146434404
1956,NJ,M,38226,20668,58894,35.093557917614696
1956,NM,F,9729,1242,10971,11.320754716981133
1956,NM,M,8977,3149,12126,25.968992248062015
1956,NV,F,1886,206,2092,9.847036328871893
1956,NV,M,1842,835,2677,31.19163242435562
1956,NY,F,148397,16294,164691,9.893679678913845
1956,NY,M,116086,60112,176198,34.11616476918013
1956,OH,F,95483,11851,107334,11.041235768721934
1956,OH,M,79185,36368,115553,31.47300372989018
1956,OK,F,20073,2206,22279,9.901701153552674
1956,OK,M,18800,6050,24850,24.346076458752517
1956,OR,F,14860,1260,16120,7.816377171215881
1956,OR,M,12804,5074,17878,28.38125069918335
1956,PA,F,102894,12896,115790,11.137403920891268
1956,PA,M,80603,42381,122984,34.46058023807975
1956,RI,F,7419,979,8398,11.657537508930698
1956,RI,M,5524,3657,9181,39.832262280797295
1956,SC,F,25567,3356,28923,11.60322234899561
1956,SC,M,23349,7411,30760,24.092977893368012
1956,SD,F,6837,635,7472,8.498394004282655
1956,SD,M,6062,2145,8207,26.136225173632265
1956,TN,F,33862,4524,38386,11.785546813942585
1956,TN,M,30889,10048,40937,24.545032611085325
1956,TX,F,103329,11482,114811,10.000783897013351
1956,TX,M,93847,30019,123866,24.235060468570875
1956,UT,F,9884,652,10536,6.18830675778284
1956,UT,M,9180,2838,12018,23.614578132800798
1956,VA,F,36201,5134,41335,12.420466916656586
1956,VA,M,32421,11942,44363,26.918828753691137
1956,VT,F,3074,397,3471,11.437626044367617
1956,VT,M,2626,1324,3950,33.51898734177215
1956,WA,F,26366,2275,28641,7.943158409273419
1956,WA,M,22770,8976,31746,28.274428274428274
1956,WI,F,37641,4331,41972,10.318783951205566
1956,WI,M,30126,15609,45735,34.129222695965886
1956,WV,F,17306,2601,19907,13.065755764304013
1956,WV,M,15481,6081,21562,28.20239309897041
1956,WY,F,2661,277,2938,9.428182437031994
1956,WY,M,2520,992,3512,28.246013667425967
1957,AK,F,2453,297,2750,10.8
1957,AK,M,2307,1103,3410,32.34604105571848
1957,AL,F,32817,3832,36649,10.455946956260744
1957,AL,M,30310,9133,39443,23.154932434145476
1957,AR,F,16621,1934,18555,10.42306655887901
1957,AR,M,15915,4495,20410,22.023517883390493
1957,AZ,F,12265,1388,13653,10.16626382480041
1957,AZ,M,11218,4023,15241,26.3959057804606
1957,CA,F,151122,12792,163914,7.804092389911784
1957,CA,M,126146,49838,175984,28.319619965451402
1957,CO,F,17013,1657,18670,8.875200856989823
1957,CO,M,14857,5867,20724,28.310171781509364
1957,CT,F,22328,2541,24869,10.21753990912381
1957,CT,M,16689,10063,26752,37.61587918660287
1957,DC,F,12002,1615,13617,11.860174781523096
1957,DC,M,10044,4891,14935,32.748577167726815
1957,DE,F,4176,632,4808,13.14475873544093
1957,DE,M,3406,1849,5255,35.185537583254046
1957,FL,F,41326,4591,45917,9.998475510159636
1957,FL,M,36689,13378,50067,26.720194938782033
1957,GA,F,41327,4682,46009,10.176269860244734
1957,GA,M,38134,11717,49851,23.50404204529498
1957,HI,F,5661,405,6066,6.6765578635014835
1957,HI,M,5415,1878,7293,25.75071986836693
1957,IA,F,26160,2384,28544,8.352017937219731
1957,IA,M,22177,8811,30988,28.43358719504324
1957,ID,F,5959,394,6353,6.201794427829372
1957,ID,M,5523,1793,7316,24.50792782941498
1957,IL,F,97658,10772,108430,9.934519966798856
1957,IL,M,79543,36543,116086,31.47924814361766
1957,IN,F,46930,4937,51867,9.518576358763761
1957,IN,M,39766,16280,56046,29.04756806908611
1957,KS,F,19809,1981,21790,9.091326296466269
1957,KS,M,17992,6253,24245,25.790884718498656
1957,KY,F,29763,3973,33736,11.776737016836613
1957,KY,M,27057,9367,36424,25.716560509554142
1957,LA,F,36080,3732,39812,9.374058072942832
1957,LA,M,33404,9948,43352,22.947038198929693
1957,MA,F,48174,5613,53787,10.435607116961346
1957,MA,M,33447,24041,57488,41.819162259949906
1957,MD,F,26777,3611,30388,11.882980123733052
1957,MD,M,22588,10203,32791,31.11524503674789
1957,ME,F,8850,958,9808,9.767536704730832
1957,ME,M,7096,3550,10646,33.34585759909825
1957,MI,F,86397,8691,95088,9.139954568399798
1957,MI,M,70343,31104,101447,30.66034481059075
1957,MN,F,34979,3481,38460,9.050962038481538
1957,MN,M,28057,13047,41104,31.74143635655897
1957,MO,F,40464,4685,45149,10.376752530510089
1957,MO,M,34736,13871,48607,28.537041989836855
1957,MS,F,23199,2869,26068,11.005830903790088
1957,MS,M,22021,6160,28181,21.85869912352294
1957,MT,F,6614,589,7203,8.177148410384563
1957,MT,M,5808,2196,8004,27.436281859070466
1957,NC,F,45340,5271,50611,10.414731975262296
1957,NC,M,41444,12752,54196,23.52941176470588
1957,ND,F,6142,533,6675,7.985018726591759
1957,ND,M,5497,1828,7325,24.955631399317408
1957,NE,F,12883,1292,14175,9.114638447971782
1957,NE,M,11377,4267,15644,27.275632830478138
1957,NH,F,4944,573,5517,10.386079390973354
1957,NH,M,3924,2201,6125,35.93469387755102
1957,NJ,F,52094,5493,57587,9.538611144876448
1957,NJ,M,40210,21220,61430,34.54338271202995
1957,NM,F,10273,1209,11482,10.529524473088312
1957,NM,M,9229,3302,12531,26.35065038704014
1957,NV,F,1982,183,2165,8.452655889145497
1957,NV,M,1827,766,2593,29.54107211723872
1957,NY,F,153341,15903,169244,9.396492637848313
1957,NY,M,119316,61725,181041,34.09448688418645
1957,OH,F,99902,11138,111040,10.030619596541786
1957,OH,M,82866,36447,119313,30.547383772095245
1957,OK,F,19807,2041,21848,9.341816184547785
1957,OK,M,18374,5763,24137,23.876206653685212
1957,OR,F,14762,1175,15937,7.372780322519922
1957,OR,M,12742,4881,17623,27.696759916018838
1957,PA,F,105958,12117,118075,10.262121532923988
1957,PA,M,83284,43487,126771,34.30358678246602
1957,RI,F,7687,842,8529,9.872200726931645
1957,RI,M,5626,3629,9255,39.211237169097785
1957,SC,F,25353,3027,28380,10.665961945031713
1957,SC,M,22894,7506,30400,24.69078947368421
1957,SD,F,6486,581,7067,8.221310315551152
1957,SD,M,5960,2045,8005,25.546533416614615
1957,TN,F,33627,4034,37661,10.71134595470115
1957,TN,M,30777,10140,40917,24.781875504069216
1957,TX,F,104351,11050,115401,9.57530697307649
1957,TX,M,95127,29775,124902,23.838689532593555
1957,UT,F,9900,624,10524,5.929304446978335
1957,UT,M,9508,2769,12277,22.554369960087968
1957,VA,F,36845,4611,41456,11.12263604785797
1957,VA,M,32430,11744,44174,26.585774437451892
1957,VT,F,3153,419,3572,11.730123180291153
1957,VT,M,2623,1404,4027,34.864663521231684
1957,WA,F,26711,2063,28774,7.169667060540766
1957,WA,M,22941,8948,31889,28.059832544137475
1957,WI,F,39632,4280,43912,9.746766259792313
1957,WI,M,30955,15730,46685,33.69390596551355
1957,WV,F,17550,2204,19754,11.157233977928522
1957,WV,M,15640,5929,21569,27.488525198201124
1957,WY,F,2596,262,2858,9.167249825052485
1957,WY,M,2386,1023,3409,30.008800234672922
1958,AK,F,2242,280,2522,11.102299762093576
1958,AK,M,2209,933,3142,29.69446212603437
1958,AL,F,32590,3388,35978,9.41686586247151
1958,AL,M,29557,8705,38262,22.751032355862215
1958,AR,F,16250,1674,17924,9.33943316224057
1958,AR,M,15419,4318,19737,21.877691645133506
1958,AZ,F,12702,1341,14043,9.549241615039522
1958,AZ,M,11489,3899,15388,25.337925656355605
1958,CA,F,151192,11695,162887,7.179824049801396
1958,CA,M,126445,48128,174573,27.568982603266257
1958,CO,F,17012,1538,18550,8.2911051212938
1958,CO,M,14929,5862,20791,28.194892020585833
1958,CT,F,22020,2252,24272,9.278180619644035
1958,CT,M,16389,10061,26450,38.03780718336484
1958,DC,F,12075,1445,13520,10.687869822485208
1958,DC,M,10098,4813,14911,32.27818389108712
1958,DE,F,4054,529,4583,11.542657647828932
1958,DE,M,3326,1849,5175,35.729468599033815
1958,FL,F,43140,4283,47423,9.031482613921515
1958,FL,M,38019,13665,51684,26.43951706524263
1958,GA,F,40920,4176,45096,9.260244811069718
1958,GA,M,37407,11034,48441,22.778225057286182
1958,HI,F,5513,400,5913,6.764755623203111
1958,HI,M,5278,1887,7165,26.33635729239358
1958,IA,F,25450,2047,27497,7.444448485289304
1958,IA,M,22065,8303,30368,27.341280295047422
1958,ID,F,5869,421,6290,6.6931637519872815
1958,ID,M,5635,1723,7358,23.41668931774939
1958,IL,F,96500,9650,106150,9.090909090909092
1958,IL,M,78752,35145,113897,30.856826782092593
1958,IN,F,46006,4436,50442,8.79425875262678
1958,IN,M,39254,15450,54704,28.242907282831236
1958,KS,F,19408,1619,21027,7.699624292576211
1958,KS,M,17463,5937,23400,25.371794871794872
1958,KY,F,29286,3623,32909,11.009146434106173
1958,KY,M,26659,9212,35871,25.680912157453093
1958,LA,F,35828,3480,39308,8.853159662155287
1958,LA,M,32898,9813,42711,22.97534592962
1958,MA,F,48400,5172,53572,9.654297020831777
1958,MA,M,33409,23856,57265,41.658953985855234
1958,MD,F,26695,3314,30009,11.043353660568496
1958,MD,M,22131,9979,32110,31.077545935845528
1958,ME,F,8788,808,9596,8.420175072947062
1958,ME,M,7182,3552,10734,33.091112353269985
1958,MI,F,84425,7514,91939,8.172810232871795
1958,MI,M,68947,29772,98719,30.15832818403752
1958,MN,F,34545,3199,37744,8.475519287833828
1958,MN,M,28215,12661,40876,30.974165769644777
1958,MO,F,40337,4184,44521,9.397812268367737
1958,MO,M,35085,13470,48555,27.741736175471114
1958,MS,F,22765,2523,25288,9.977064220183486
1958,MS,M,21241,5791,27032,21.4227582124889
1958,MT,F,6062,512,6574,7.7882567690903555
1958,MT,M,5670,2000,7670,26.07561929595828
1958,NC,F,44291,4915,49206,9.988619274072267
1958,NC,M,40287,12135,52422,23.14867803593911
1958,ND,F,6149,470,6619,7.100770509140355
1958,ND,M,5647,1782,7429,23.987077668596044
1958,NE,F,12718,1160,13878,8.358553105634819
1958,NE,M,11289,4428,15717,28.17331551822867
1958,NH,F,4928,426,5354,7.956667911841614
1958,NH,M,4013,2204,6217,35.45118224223902
1958,NJ,F,52334,5106,57440,8.889275766016713
1958,NJ,M,40028,20883,60911,34.28444780088982
1958,NM,F,10317,1202,11519,10.434933587985068
1958,NM,M,9592,3211,12803,25.080059361087244
1958,NV,F,2037,143,2180,6.559633027522936
1958,NV,M,1864,756,2620,28.854961832061072
1958,NY,F,154627,14898,169525,8.788084353340215
1958,NY,M,119350,61320,180670,33.94033320418443
1958,OH,F,97242,9564,106806,8.954553114993539
1958,OH,M,80174,34168,114342,29.8822829756345
1958,OK,F,19632,1689,21321,7.9217672717039544
1958,OK,M,17938,5687,23625,24.071957671957673
1958,OR,F,14166,1025,15191,6.74741623329603
1958,OR,M,12327,4513,16840,26.799287410926365
1958,PA,F,105049,10834,115883,9.349084852825696
1958,PA,M,81616,41589,123205,33.75593522990138
1958,RI,F,7252,789,8041,9.812212411391616
1958,RI,M,5290,3569,8859,40.28671407608082
1958,SC,F,24123,2727,26850,10.156424581005586
1958,SC,M,21970,7007,28977,24.18124719605204
1958,SD,F,6538,507,7045,7.196593328601845
1958,SD,M,5802,1939,7741,25.04844335357189
1958,TN,F,33028,3607,36635,9.845775897365906
1958,TN,M,30516,9585,40101,23.902147078626466
1958,TX,F,102104,10154,112258,9.04523508346844
1958,TX,M,93626,28936,122562,23.609275305559635
1958,UT,F,9767,552,10319,5.349355557709081
1958,UT,M,9097,2600,11697,22.22792168932205
1958,VA,F,36711,4099,40810,10.044106836559667
1958,VA,M,31915,11542,43457,26.559587638355154
1958,VT,F,3210,379,3589,10.560044580663137
1958,VT,M,2575,1396,3971,35.15487282800302
1958,WA,F,26610,1856,28466,6.520059017775592
1958,WA,M,23166,8348,31514,26.489814050898016
1958,WI,F,39580,3759,43339,8.67348116015598
1958,WI,M,31227,15403,46630,33.03238258631782
1958,WV,F,17376,1951,19327,10.09468619030372
1958,WV,M,15705,5785,21490,26.91949744067008
1958,WY,F,2492,238,2730,8.717948717948717
1958,WY,M,2345,929,3274,28.375076359193645
1959,AK,F,2308,248,2556,9.702660406885759
1959,AK,M,2016,878,2894,30.33863165169316
1959,AL,F,32166,3229,35395,9.12275745161746
1959,AL,M,29594,8814,38408,22.948344094980214
1959,AR,F,16170,1631,17801,9.162406606370428
1959,AR,M,15266,4322,19588,22.0645293036553
1959,AZ,F,13108,1285,14393,8.92795108733412
1959,AZ,M,12083,4073,16156,25.21044813072543
1959,CA,F,154496,11793,166289,7.091870177822947
1959,CA,M,130977,48667,179644,27.09080180802031
1959,CO,F,17512,1403,18915,7.417393602960614
1959,CO,M,15636,5694,21330,26.694796061884666
1959,CT,F,22153,2270,24423,9.294517463047129
1959,CT,M,16643,9969,26612,37.46054411543665
1959,DC,F,11825,1325,13150,10.076045627376425
1959,DC,M,10148,4702,14850,31.663299663299664
1959,DE,F,4103,511,4614,11.07498916341569
1959,DE,M,3386,1805,5191,34.77172028510884
1959,FL,F,44728,4109,48837,8.413702725392632
1959,FL,M,39862,13826,53688,25.75249590225004
1959,GA,F,40742,4035,44777,9.011322777318712
1959,GA,M,36983,10972,47955,22.879783130017724
1959,HI,F,5637,429,6066,7.072205736894165
1959,HI,M,5307,1830,7137,25.64102564102564
1959,IA,F,26596,2027,28623,7.081717499912657
1959,IA,M,22822,8185,31007,26.397265133679493
1959,ID,F,5960,386,6346,6.082571698707848
1959,ID,M,5933,1669,7602,21.95474875032886
1959,IL,F,98810,9547,108357,8.81069058759471
1959,IL,M,81277,35056,116333,30.134183765569528
1959,IN,F,45947,4082,50029,8.159267624777629
1959,IN,M,39583,15219,54802,27.77088427429656
1959,KS,F,20144,1621,21765,7.447737192740639
1959,KS,M,17912,5857,23769,24.641339559931
1959,KY,F,29570,3408,32978,10.33416216871854
1959,KY,M,27025,9137,36162,25.266854709363418
1959,LA,F,36398,3251,39649,8.199450175288153
1959,LA,M,32738,9883,42621,23.188099763027616
1959,MA,F,48500,4944,53444,9.250804580495473
1959,MA,M,32716,23678,56394,41.98673617760755
1959,MD,F,27354,3152,30506,10.332393627483118
1959,MD,M,22772,10062,32834,30.64506304440519
1959,ME,F,9000,877,9877,8.879214336336945
1959,ME,M,7182,3450,10632,32.44920993227991
1959,MI,F,82771,7320,90091,8.125117936308843
1959,MI,M,67498,28972,96470,30.032134342282575
1959,MN,F,36431,3231,39662,8.14633654379507
1959,MN,M,29142,13083,42225,30.984014209591475
1959,MO,F,41028,3950,44978,8.782071234825915
1959,MO,M,35899,13320,49219,27.062719681423843
1959,MS,F,23416,2549,25965,9.817061428846523
1959,MS,M,21708,5950,27658,21.512763034203488
1959,MT,F,6274,516,6790,7.59941089837997
1959,MT,M,5803,1984,7787,25.478361371516627
1959,NC,F,44492,4576,49068,9.325833537132143
1959,NC,M,40572,12088,52660,22.954804405620965
1959,ND,F,6465,477,6942,6.871218668971478
1959,ND,M,5786,1781,7567,23.53640808774944
1959,NE,F,13542,1114,14656,7.600982532751091
1959,NE,M,11669,4496,16165,27.813176616145995
1959,NH,F,5006,501,5507,9.097512257127292
1959,NH,M,3882,2164,6046,35.792259345021506
1959,NJ,F,52296,4864,57160,8.509447165850245
1959,NJ,M,40093,21182,61275,34.568747450020396
1959,NM,F,10846,1160,12006,9.66183574879227
1959,NM,M,10016,3324,13340,24.917541229385307
1959,NV,F,2004,147,2151,6.834030683403068
1959,NV,M,1917,801,2718,29.47019867549669
1959,NY,F,153923,14299,168222,8.500077278833922
1959,NY,M,119428,61360,180788,33.940305772507024
1959,OH,F,96577,9312,105889,8.794114591695076
1959,OH,M,79342,33955,113297,29.96990211567826
1959,OK,F,19756,1586,21342,7.43135601162028
1959,OK,M,18615,5357,23972,22.34690472217587
1959,OR,F,14367,906,15273,5.9320369279120015
1959,OR,M,12740,4419,17159,25.753249023835888
1959,PA,F,104090,10252,114342,8.966084203529762
1959,PA,M,80073,41619,121692,34.200276106892815
1959,RI,F,7500,782,8282,9.442163728567978
1959,RI,M,5367,3526,8893,39.649162262453615
1959,SC,F,23922,2670,26592,10.040613718411553
1959,SC,M,21620,6942,28562,24.30502065681675
1959,SD,F,6822,473,7295,6.483893077450309
1959,SD,M,6149,1965,8114,24.217402021197927
1959,TN,F,33356,3226,36582,8.818544639440162
1959,TN,M,30234,9600,39834,24.100015062509414
1959,TX,F,103973,9799,113772,8.612839714516753
1959,TX,M,94344,28812,123156,23.394718893111175
1959,UT,F,9768,534,10302,5.18345952242283
1959,UT,M,9291,2566,11857,21.64122459306739
1959,VA,F,36723,3884,40607,9.564853350407565
1959,VA,M,31788,11417,43205,26.425182270570534
1959,VT,F,3227,364,3591,10.1364522417154
1959,VT,M,2706,1381,4087,33.790066063126986
1959,WA,F,26683,1836,28519,6.437813387566184
1959,WA,M,23327,8160,31487,25.915457172801474
1959,WI,F,40797,3625,44422,8.160370987348612
1959,WI,M,32118,15387,47505,32.390274707925485
1959,WV,F,16574,1746,18320,9.530567685589519
1959,WV,M,14606,5464,20070,27.22471350274041
1959,WY,F,2551,247,2798,8.827734095782702
1959,WY,M,2471,851,3322,25.617098133654427
1960,AK,F,2384,229,2613,8.76387294297742
1960,AK,M,2219,988,3207,30.807608356719673
1960,AL,F,31608,3103,34711,8.939529255855492
1960,AL,M,29106,8715,37821,23.042754025541363
1960,AR,F,16335,1461,17796,8.209710047201618
1960,AR,M,15037,4267,19304,22.10422710319105
1960,AZ,F,13862,1278,15140,8.44121532364597
1960,AZ,M,12570,4443,17013,26.115323576088873
1960,CA,F,161030,11613,172643,6.726597661069375
1960,CA,M,135443,50576,186019,27.18862051725899
1960,CO,F,18153,1394,19547,7.1315291349056125
1960,CO,M,15624,5733,21357,26.843657817109147
1960,CT,F,22512,2088,24600,8.487804878048781
1960,CT,M,16719,10011,26730,37.452300785634115
1960,DC,F,11993,1211,13204,9.171463192971826
1960,DC,M,10198,4704,14902,31.56623272044021
1960,DE,F,4111,448,4559,9.826716385172187
1960,DE,M,3327,1771,5098,34.73911337779521
1960,FL,F,46283,3984,50267,7.925676885431794
1960,FL,M,40558,14329,54887,26.106363984185695
1960,GA,F,40844,3690,44534,8.285804104728971
1960,GA,M,37473,10786,48259,22.35023518929112
1960,HI,F,5655,350,6005,5.828476269775187
1960,HI,M,5404,1872,7276,25.728422210005498
1960,IA,F,26235,1905,28140,6.769722814498934
1960,IA,M,22915,8334,31249,26.669653428909722
1960,ID,F,6105,322,6427,5.010113583320367
1960,ID,M,5806,1658,7464,22.213290460878884
1960,IL,F,98532,9089,107621,8.445377760845933
1960,IL,M,80709,35137,115846,30.330783971824665
1960,IN,F,46585,3807,50392,7.5547705985077
1960,IN,M,38967,15337,54304,28.24285503830289
1960,KS,F,19573,1455,21028,6.919345634392239
1960,KS,M,17298,5623,22921,24.532088477815105
1960,KY,F,29027,2983,32010,9.318962824117463
1960,KY,M,26315,9145,35460,25.789622109419064
1960,LA,F,35752,3079,38831,7.929231799335583
1960,LA,M,32461,9737,42198,23.074553296364755
1960,MA,F,48096,4613,52709,8.751826063860062
1960,MA,M,32891,24307,57198,42.496241127312146
1960,MD,F,27260,2901,30161,9.618381353403402
1960,MD,M,22701,10120,32821,30.833917309039943
1960,ME,F,9171,766,9937,7.708563952903291
1960,ME,M,7214,3713,10927,33.98004941887069
1960,MI,F,81641,6662,88303,7.544477537569505
1960,MI,M,66156,28261,94417,29.93210968363748
1960,MN,F,35900,2852,38752,7.3596201486374895
1960,MN,M,29022,13402,42424,31.590609089194793
1960,MO,F,41093,3672,44765,8.202837037864404
1960,MO,M,35543,13330,48873,27.274773392261576
1960,MS,F,23030,2339,25369,9.219914068351137
1960,MS,M,21111,5782,26893,21.500018592198714
1960,MT,F,6224,457,6681,6.840293369256099
1960,MT,M,5662,1947,7609,25.588119332369562
1960,NC,F,44334,4240,48574,8.728949643842384
1960,NC,M,40054,12124,52178,23.235846525355512
1960,ND,F,6185,426,6611,6.4438057782483735
1960,ND,M,5600,1770,7370,24.016282225237447
1960,NE,F,13429,1031,14460,7.130013831258644
1960,NE,M,11827,4490,16317,27.517313231598944
1960,NH,F,5043,444,5487,8.091853471842537
1960,NH,M,3855,2251,6106,36.86537831641009
1960,NJ,F,52984,4829,57813,8.352792624496221
1960,NJ,M,40253,21862,62115,35.196007405618616
1960,NM,F,11340,1030,12370,8.326596604688763
1960,NM,M,10276,3452,13728,25.145687645687648
1960,NV,F,2180,143,2323,6.155832974601808
1960,NV,M,2053,830,2883,28.789455428373223
1960,NY,F,153994,13668,167662,8.152115565840798
1960,NY,M,118175,61330,179505,34.16617921506365
1960,OH,F,96527,8662,105189,8.234701347099032
1960,OH,M,78455,33779,112234,30.09694032111481
1960,OK,F,19429,1542,20971,7.353011301320872
1960,OK,M,18415,5357,23772,22.534915026081105
1960,OR,F,15205,965,16170,5.967841682127396
1960,OR,M,13362,4693,18055,25.992799778454724
1960,PA,F,102292,9417,111709,8.429938500926514
1960,PA,M,78974,40895,119869,34.11641041470272
1960,RI,F,7483,684,8167,8.375168360475083
1960,RI,M,5363,3657,9020,40.54323725055433
1960,SC,F,23545,2522,26067,9.675068093758393
1960,SC,M,21478,6870,28348,24.234513898687737
1960,SD,F,6625,450,7075,6.36042402826855
1960,SD,M,5968,1867,7835,23.828972559029992
1960,TN,F,33407,2993,36400,8.222527472527473
1960,TN,M,30119,9365,39484,23.718468240299867
1960,TX,F,104130,9275,113405,8.178651734932323
1960,TX,M,93808,28984,122792,23.604143592416442
1960,UT,F,10167,505,10672,4.732008995502249
1960,UT,M,9476,2664,12140,21.943986820428336
1960,VA,F,36098,3721,39819,9.344785152816494
1960,VA,M,30972,11298,42270,26.72817601135557
1960,VT,F,3290,304,3594,8.45854201446856
1960,VT,M,2508,1371,3879,35.34416086620263
1960,WA,F,26587,1681,28268,5.946653459742465
1960,WA,M,22940,8046,30986,25.96656554573033
1960,WI,F,41323,3613,44936,8.04032401637885
1960,WI,M,32608,15453,48061,32.152889036849004
1960,WV,F,15816,1584,17400,9.10344827586207
1960,WV,M,13628,5334,18962,28.129944098723765
1960,WY,F,2694,213,2907,7.327141382868938
1960,WY,M,2483,908,3391,26.7767620171041
1961,AK,F,2457,235,2692,8.729569093610698
1961,AK,M,2156,960,3116,30.80872913992298
1961,AL,F,31398,2921,34319,8.511320259914333
1961,AL,M,28648,8767,37415,23.431778698383003
1961,AR,F,16025,1456,17481,8.329042960929009
1961,AR,M,15247,4287,19534,21.946349953926486
1961,AZ,F,14030,1305,15335,8.509944571242256
1961,AZ,M,12471,4482,16953,26.437798619713327
1961,CA,F,163886,11129,175015,6.358883524269348
1961,CA,M,136972,51938,188910,27.49351543062834
1961,CO,F,18507,1370,19877,6.892388187352216
1961,CO,M,16040,5935,21975,27.00796359499431
1961,CT,F,22437,2093,24530,8.532409294741134
1961,CT,M,16492,10072,26564,37.91597650956181
1961,DC,F,12035,1184,13219,8.956804599440199
1961,DC,M,10054,4815,14869,32.38280987288991
1961,DE,F,4147,453,4600,9.847826086956522
1961,DE,M,3449,1786,5235,34.11652340019102
1961,FL,F,46251,3762,50013,7.522044268490193
1961,FL,M,40583,14409,54992,26.20199301716613
1961,GA,F,40971,3562,44533,7.998562863494488
1961,GA,M,36934,10879,47813,22.753226110053753
1961,HI,F,5644,456,6100,7.475409836065573
1961,HI,M,5495,1981,7476,26.498127340823967
1961,IA,F,26386,1921,28307,6.7863072738191965
1961,IA,M,22016,8226,30242,27.200581972091793
1961,ID,F,6028,301,6329,4.755885605940907
1961,ID,M,5609,1615,7224,22.356035437430783
1961,IL,F,97953,8610,106563,8.079727485149629
1961,IL,M,79139,34650,113789,30.45109808505216
1961,IN,F,46299,3565,49864,7.149446494464945
1961,IN,M,39207,14888,54095,27.52195212126814
1961,KS,F,18981,1343,20324,6.60795119071049
1961,KS,M,16728,5667,22395,25.304755525787005
1961,KY,F,28954,2918,31872,9.155371485943775
1961,KY,M,25434,9044,34478,26.231219908347352
1961,LA,F,35076,2939,38015,7.731158753123767
1961,LA,M,31567,9645,41212,23.40337765699311
1961,MA,F,49334,4627,53961,8.574711365615908
1961,MA,M,33435,23894,57329,41.6787315320344
1961,MD,F,27590,2731,30321,9.006958873388081
1961,MD,M,22716,10117,32833,30.81351079706393
1961,ME,F,9272,779,10051,7.750472589792061
1961,ME,M,7215,3695,10910,33.86801099908341
1961,MI,F,80548,6275,86823,7.227347592227866
1961,MI,M,64928,28180,93108,30.265927739829017
1961,MN,F,35865,2757,38622,7.138418517943141
1961,MN,M,28256,12947,41203,31.42246923767687
1961,MO,F,40675,3603,44278,8.137223903518677
1961,MO,M,35122,13275,48397,27.42938611897432
1961,MS,F,22621,2155,24776,8.69793348401679
1961,MS,M,20903,6064,26967,22.486743056328105
1961,MT,F,6101,377,6478,5.819697437480704
1961,MT,M,5719,1967,7686,25.591985428051
1961,NC,F,44587,4178,48765,8.567620219419664
1961,NC,M,40306,12513,52819,23.6903387038755
1961,ND,F,6107,406,6513,6.233686473207431
1961,ND,M,5477,1793,7270,24.66299862448418
1961,NE,F,13755,1025,14780,6.935047361299053
1961,NE,M,11672,4485,16157,27.758866126137278
1961,NH,F,5174,441,5615,7.853962600178094
1961,NH,M,3878,2266,6144,36.88151041666667
1961,NJ,F,54023,4655,58678,7.933126555097311
1961,NJ,M,40921,22116,63037,35.084156923711475
1961,NM,F,10917,1038,11955,8.682559598494354
1961,NM,M,9916,3383,13299,25.438002857357695
1961,NV,F,2414,168,2582,6.506584043377226
1961,NV,M,2290,943,3233,29.167955459325707
1961,NY,F,154431,13326,167757,7.94363275451993
1961,NY,M,117590,61812,179402,34.45446539057536
1961,OH,F,96140,8055,104195,7.730697250347905
1961,OH,M,77877,33639,111516,30.165178091036264
1961,OK,F,19480,1359,20839,6.521426172081194
1961,OK,M,18266,5267,23533,22.381336846130964
1961,OR,F,14698,870,15568,5.588386433710175
1961,OR,M,12999,4575,17574,26.032775691362243
1961,PA,F,101913,9073,110986,8.17490494296578
1961,PA,M,77451,40535,117986,34.355771023680774
1961,RI,F,7528,701,8229,8.518653542350226
1961,RI,M,5326,3656,8982,40.70362948118459
1961,SC,F,23615,2327,25942,8.970010022357567
1961,SC,M,21493,6861,28354,24.197644071383227
1961,SD,F,6641,427,7068,6.041312959818902
1961,SD,M,5802,1939,7741,25.04844335357189
1961,TN,F,33231,2947,36178,8.14583448504616
1961,TN,M,30038,9342,39380,23.722701879126458
1961,TX,F,102914,8819,111733,7.89292330824376
1961,TX,M,91374,28200,119574,23.5837222138592
1961,UT,F,10121,466,10587,4.401624633985076
1961,UT,M,9440,2725,12165,22.40032881216605
1961,VA,F,36597,3575,40172,8.899233296823658
1961,VA,M,31571,11710,43281,27.05575194658164
1961,VT,F,3195,306,3501,8.740359897172237
1961,VT,M,2613,1310,3923,33.39281162375733
1961,WA,F,26231,1568,27799,5.640490665131839
1961,WA,M,22556,8211,30767,26.687684857152146
1961,WI,F,40872,3316,44188,7.504299809903141
1961,WI,M,31618,15749,47367,33.24888635547955
1961,WV,F,15338,1456,16794,8.669763010599024
1961,WV,M,13408,5381,18789,28.639097344190752
1961,WY,F,2768,155,2923,5.302771125555935
1961,WY,M,2528,977,3505,27.87446504992867
1962,AK,F,2450,245,2695,9.090909090909092
1962,AK,M,2204,967,3171,30.495111952065596
1962,AL,F,30705,2663,33368,7.980700071925198
1962,AL,M,27881,8497,36378,23.357523778107648
1962,AR,F,16245,1382,17627,7.840245078572644
1962,AR,M,15295,4289,19584,21.900531045751634
1962,AZ,F,14282,1168,15450,7.559870550161812
1962,AZ,M,12417,4519,16936,26.682805857345297
1962,CA,F,162322,11123,173445,6.412983943036697
1962,CA,M,135818,51275,187093,27.406156296601154
1962,CO,F,17899,1274,19173,6.644760861628332
1962,CO,M,15771,5831,21602,26.99287103046014
1962,CT,F,21802,1869,23671,7.895737400194331
1962,CT,M,16222,9749,25971,37.53802317970044
1962,DC,F,11992,1076,13068,8.233853688399142
1962,DC,M,9974,4506,14480,31.11878453038674
1962,DE,F,3963,408,4371,9.334248455730954
1962,DE,M,3223,1738,4961,35.033259423503324
1962,FL,F,45450,3781,49231,7.680120249436332
1962,FL,M,39982,14237,54219,26.258322728194912
1962,GA,F,40234,3470,43704,7.939776679480139
1962,GA,M,36234,10691,46925,22.78316462440064
1962,HI,F,5930,442,6372,6.936597614563716
1962,HI,M,5610,1956,7566,25.852498017446475
1962,IA,F,25605,1755,27360,6.4144736842105265
1962,IA,M,21277,7793,29070,26.80770553835569
1962,ID,F,5739,297,6036,4.920477137176938
1962,ID,M,5387,1608,6995,22.98784846318799
1962,IL,F,94938,7903,102841,7.684678289787147
1962,IL,M,76477,33770,110247,30.631218990085895
1962,IN,F,45028,3379,48407,6.980395397359886
1962,IN,M,37979,14309,52288,27.36574357405141
1962,KS,F,18504,1326,19830,6.686838124054463
1962,KS,M,16646,5319,21965,24.21579786023219
1962,KY,F,28130,2689,30819,8.725137090755702
1962,KY,M,25101,9014,34115,26.42239484097904
1962,LA,F,35118,2940,38058,7.725051237584739
1962,LA,M,31016,9427,40443,23.309348960265062
1962,MA,F,47279,4111,51390,7.999610819225531
1962,MA,M,32442,23312,55754,41.812246654948524
1962,MD,F,26705,2593,29298,8.85043347668783
1962,MD,M,21705,9975,31680,31.486742424242426
1962,ME,F,9178,744,9922,7.498488208022576
1962,ME,M,7109,3589,10698,33.54832679005422
1962,MI,F,76293,5786,82079,7.0493061562640875
1962,MI,M,61701,26653,88354,30.166149806460375
1962,MN,F,35276,2619,37895,6.911202005541628
1962,MN,M,27717,12784,40501,31.564652724624082
1962,MO,F,39344,3262,42606,7.656198657466085
1962,MO,M,33811,12645,46456,27.219304287928363
1962,MS,F,22641,2092,24733,8.458335017992157
1962,MS,M,21014,5834,26848,21.72973778307509
1962,MT,F,5832,381,6213,6.132303235152101
1962,MT,M,5478,1924,7402,25.992974871656312
1962,NC,F,43740,3945,47685,8.273041837055677
1962,NC,M,39223,12227,51450,23.764820213799805
1962,ND,F,5784,399,6183,6.453178068898594
1962,ND,M,5153,1696,6849,24.762739085997957
1962,NE,F,13489,859,14348,5.986897128519654
1962,NE,M,11671,4487,16158,27.769525931427157
1962,NH,F,5154,403,5557,7.252114450242937
1962,NH,M,3839,2285,6124,37.312214239059436
1962,NJ,F,52707,4317,57024,7.570496632996633
1962,NJ,M,40051,21438,61489,34.86477256094586
1962,NM,F,10571,958,11529,8.309480440627981
1962,NM,M,9896,3394,13290,25.537998495109104
1962,NV,F,2566,174,2740,6.350364963503649
1962,NV,M,2351,1027,3378,30.40260509177028
1962,NY,F,151006,12257,163263,7.5075185436994305
1962,NY,M,114862,59902,174764,34.27593783616763
1962,OH,F,90953,7532,98485,7.647865157130528
1962,OH,M,73557,31926,105483,30.266488438895365
1962,OK,F,19282,1334,20616,6.47070236709352
1962,OK,M,18163,5387,23550,22.874734607218684
1962,OR,F,14585,816,15401,5.298357249529252
1962,OR,M,12695,4497,17192,26.157515123313168
1962,PA,F,96172,8163,104335,7.823836679925241
1962,PA,M,72976,38012,110988,34.24874761235449
1962,RI,F,7197,632,7829,8.072550772767913
1962,RI,M,5088,3617,8705,41.55083285468122
1962,SC,F,23157,2220,25377,8.748078969145288
1962,SC,M,20439,6787,27226,24.928377286417394
1962,SD,F,6295,405,6700,6.044776119402985
1962,SD,M,5857,1846,7703,23.964689082175774
1962,TN,F,32920,2694,35614,7.5644409501881285
1962,TN,M,29539,9201,38740,23.750645327826536
1962,TX,F,102018,8529,110547,7.715270427962767
1962,TX,M,91313,28149,119462,23.563141417354473
1962,UT,F,10043,516,10559,4.886826404015531
1962,UT,M,9282,2773,12055,23.002903359601827
1962,VA,F,36692,3561,40253,8.846545599085783
1962,VA,M,31417,11878,43295,27.435038688070218
1962,VT,F,3133,264,3397,7.771563143950544
1962,VT,M,2523,1336,3859,34.62036797097694
1962,WA,F,26133,1611,27744,5.80666089965398
1962,WA,M,22451,8116,30567,26.55150979814833
1962,WI,F,39282,3058,42340,7.222484648086916
1962,WI,M,30662,14837,45499,32.60950790127256
1962,WV,F,14788,1347,16135,8.348311124883793
1962,WV,M,12666,5031,17697,28.428547211391763
1962,WY,F,2400,165,2565,6.432748538011696
1962,WY,M,2373,896,3269,27.40899357601713
1963,AK,F,2449,256,2705,9.463955637707947
1963,AK,M,2279,949,3228,29.399008674101612
1963,AL,F,29525,2536,32061,7.9099217117370015
1963,AL,M,26697,8351,35048,23.827322529102947
1963,AR,F,16245,1244,17489,7.11304248384699
1963,AR,M,15067,4391,19458,22.56655360263131
1963,AZ,F,13879,1175,15054,7.805234489172314
1963,AZ,M,12244,4380,16624,26.34744947064485
1963,CA,F,163178,10906,174084,6.264791709749316
1963,CA,M,136225,51649,187874,27.491297358868177
1963,CO,F,17668,1180,18848,6.260611205432936
1963,CO,M,15284,5672,20956,27.066234014124834
1963,CT,F,22353,1948,24301,8.016131023414674
1963,CT,M,16154,9930,26084,38.06931452231253
1963,DC,F,11755,1070,12825,8.343079922027291
1963,DC,M,10085,4589,14674,31.27299986370451
1963,DE,F,4000,403,4403,9.152850329320918
1963,DE,M,3286,1769,5055,34.99505440158259
1963,FL,F,44950,3560,48510,7.338693052978767
1963,FL,M,39317,14235,53552,26.58164027487302
1963,GA,F,40488,3116,43604,7.146133382258508
1963,GA,M,36205,10807,47012,22.987747809070026
1963,HI,F,5733,342,6075,5.62962962962963
1963,HI,M,5333,2008,7341,27.353221631930253
1963,IA,F,23712,1622,25334,6.402463093076498
1963,IA,M,20412,7672,28084,27.31804586241276
1963,ID,F,5247,286,5533,5.168986083499006
1963,ID,M,4868,1415,6283,22.52108865191787
1963,IL,F,91566,7532,99098,7.600557024359725
1963,IL,M,74931,32903,107834,30.512639798208358
1963,IN,F,43856,3225,47081,6.849896986045326
1963,IN,M,37027,14292,51319,27.849334554453513
1963,KS,F,17362,1252,18614,6.726120124637369
1963,KS,M,15588,5002,20590,24.293346284604176
1963,KY,F,27750,2429,30179,8.048643096192718
1963,KY,M,24304,8778,33082,26.534066864155736
1963,LA,F,33582,2548,36130,7.052311098809853
1963,LA,M,30503,9135,39638,23.046066905494726
1963,MA,F,47758,3963,51721,7.662264844067207
1963,MA,M,31920,22887,54807,41.7592643275494
1963,MD,F,27281,2581,29862,8.64309155448396
1963,MD,M,22683,10120,32803,30.85083681370606
1963,ME,F,8677,646,9323,6.929100075083127
1963,ME,M,6652,3429,10081,34.014482690209306
1963,MI,F,74549,5504,80053,6.87544501767579
1963,MI,M,59918,26144,86062,30.378099509655833
1963,MN,F,33106,2408,35514,6.780424621276117
1963,MN,M,26341,12338,38679,31.89844618526849
1963,MO,F,37989,3075,41064,7.4883109292811225
1963,MO,M,32333,12266,44599,27.502858808493464
1963,MS,F,21631,2007,23638,8.49056603773585
1963,MS,M,20095,5743,25838,22.226952550507008
1963,MT,F,5382,347,5729,6.056903473555594
1963,MT,M,5134,1806,6940,26.02305475504323
1963,NC,F,42551,3814,46365,8.226032567669577
1963,NC,M,38376,12077,50453,23.93712960577171
1963,ND,F,5418,334,5752,5.806675938803894
1963,ND,M,4943,1781,6724,26.48720999405116
1963,NE,F,12934,907,13841,6.552994725814609
1963,NE,M,11034,4312,15346,28.098527303531867
1963,NH,F,5049,373,5422,6.8793803024714135
1963,NH,M,3916,2184,6100,35.80327868852459
1963,NJ,F,53189,4289,57478,7.461985455304639
1963,NJ,M,40165,21643,61808,35.01650271809474
1963,NM,F,10123,888,11011,8.064662610117155
1963,NM,M,9124,3065,12189,25.145623102797604
1963,NV,F,2846,197,3043,6.473874465987513
1963,NV,M,2595,1081,3676,29.406964091403697
1963,NY,F,151187,11960,163147,7.3308120897105065
1963,NY,M,114274,60351,174625,34.56034359341446
1963,OH,F,88870,6928,95798,7.2318837554019915
1963,OH,M,71868,31437,103305,30.431247277479308
1963,OK,F,18914,1226,20140,6.087388282025819
1963,OK,M,17416,5139,22555,22.78430503214365
1963,OR,F,13596,771,14367,5.366464815201503
1963,OR,M,12093,4174,16267,25.659310260035657
1963,PA,F,94046,7749,101795,7.612358170833539
1963,PA,M,71460,37693,109153,34.532262054180826
1963,RI,F,7122,623,7745,8.043899289864429
1963,RI,M,5068,3438,8506,40.41852809781331
1963,SC,F,22536,2171,24707,8.786983445986968
1963,SC,M,20273,6683,26956,24.792254043626652
1963,SD,F,6130,396,6526,6.068035550107263
1963,SD,M,5523,1849,7372,25.08138903960933
1963,TN,F,32185,2563,34748,7.375964084263842
1963,TN,M,28941,9196,38137,24.113066051341217
1963,TX,F,98938,8266,107204,7.71053318906011
1963,TX,M,87970,27447,115417,23.780725543030922
1963,UT,F,9500,432,9932,4.349577124446234
1963,UT,M,8730,2628,11358,23.137876386687797
1963,VA,F,36539,3264,39803,8.200386905509635
1963,VA,M,31547,11653,43200,26.974537037037038
1963,VT,F,3019,250,3269,7.647598654022637
1963,VT,M,2497,1234,3731,33.07424283034039
1963,WA,F,24103,1489,25592,5.818224445139106
1963,WA,M,21254,7623,28877,26.398171555216955
1963,WI,F,37868,2916,40784,7.149862691251471
1963,WI,M,29424,14527,43951,33.05271779936748
1963,WV,F,13901,1232,15133,8.141148483446772
1963,WV,M,12244,4774,17018,28.052650135151012
1963,WY,F,2359,146,2505,5.828343313373254
1963,WY,M,2148,842,2990,28.160535117056856
1964,AK,F,2269,252,2521,9.996033320111067
1964,AK,M,2147,973,3120,31.185897435897438
1964,AL,F,29706,2449,32155,7.616233867205723
1964,AL,M,26567,8511,35078,24.263070870631164
1964,AR,F,16182,1228,17410,7.053417576105686
1964,AR,M,14680,4374,19054,22.955809803715756
1964,AZ,F,13491,1132,14623,7.741229569855706
1964,AZ,M,11937,4365,16302,26.775855723224147
1964,CA,F,161168,10677,171845,6.213157205621345
1964,CA,M,131496,52063,183559,28.363087617605238
1964,CO,F,16584,1154,17738,6.505806742586537
1964,CO,M,14593,5556,20149,27.574569457541315
1964,CT,F,22316,1893,24209,7.819406006030814
1964,CT,M,16355,9904,26259,37.71659240641304
1964,DC,F,11494,975,12469,7.819392092389125
1964,DC,M,9553,4558,14111,32.30104174048615
1964,DE,F,3923,372,4295,8.661233993015134
1964,DE,M,3197,1767,4964,35.59629331184529
1964,FL,F,44473,3554,48027,7.400004164324233
1964,FL,M,38307,14413,52720,27.338770864946888
1964,GA,F,40690,3189,43879,7.2677134848105025
1964,GA,M,36398,11292,47690,23.67791989934997
1964,HI,F,5474,319,5793,5.5066459520110485
1964,HI,M,5120,2038,7158,28.47164012293937
1964,IA,F,22672,1472,24144,6.096752816434725
1964,IA,M,19475,7429,26904,27.612994350282488
1964,ID,F,4860,258,5118,5.041031652989449
1964,ID,M,4467,1457,5924,24.594868332207966
1964,IL,F,91145,7000,98145,7.132304243721024
1964,IL,M,72863,32780,105643,31.029031738969927
1964,IN,F,43754,3094,46848,6.604337431693989
1964,IN,M,36289,14564,50853,28.63941163746485
1964,KS,F,16087,1090,17177,6.345694824474587
1964,KS,M,14542,5056,19598,25.798550872538012
1964,KY,F,27274,2527,29801,8.479581222106642
1964,KY,M,23890,8893,32783,27.126864533447215
1964,LA,F,33599,2715,36314,7.476455361568542
1964,LA,M,30411,9354,39765,23.523198792908335
1964,MA,F,46343,3844,50187,7.659354015980234
1964,MA,M,31160,22651,53811,42.09362398022709
1964,MD,F,27699,2363,30062,7.860421794957088
1964,MD,M,22623,10333,32956,31.35392644738439
1964,ME,F,8380,595,8975,6.629526462395543
1964,ME,M,6522,3345,9867,33.900881726968684
1964,MI,F,72833,5296,78129,6.778532939113517
1964,MI,M,58411,25836,84247,30.666967369757973
1964,MN,F,31617,2289,33906,6.751017519023182
1964,MN,M,24891,12216,37107,32.92101220793921
1964,MO,F,36658,2853,39511,7.220773961681556
1964,MO,M,31019,12099,43118,28.06020687415928
1964,MS,F,20749,1939,22688,8.546368124118477
1964,MS,M,19586,5590,25176,22.203686050206546
1964,MT,F,5076,295,5371,5.492459504747719
1964,MT,M,4828,1714,6542,26.199938856618772
1964,NC,F,42490,3620,46110,7.850791585339406
1964,NC,M,37168,12032,49200,24.45528455284553
1964,ND,F,5300,312,5612,5.559515324305061
1964,ND,M,4536,1644,6180,26.601941747572816
1964,NE,F,12200,825,13025,6.333973128598848
1964,NE,M,10253,3960,14213,27.861816646731864
1964,NH,F,4993,385,5378,7.158795091111937
1964,NH,M,3794,2193,5987,36.62936362117922
1964,NJ,F,52791,4109,56900,7.221441124780316
1964,NJ,M,39629,22049,61678,35.74856512857097
1964,NM,F,9691,888,10579,8.393988089611494
1964,NM,M,8693,3051,11744,25.979223433242502
1964,NV,F,3076,185,3261,5.67310640907697
1964,NV,M,2701,1152,3853,29.898780171295098
1964,NY,F,149209,11368,160577,7.079469662529503
1964,NY,M,112274,59931,172205,34.80212537382771
1964,OH,F,87365,6617,93982,7.040709923176778
1964,OH,M,69770,31625,101395,31.189900882686523
1964,OK,F,17761,1147,18908,6.066215358578379
1964,OK,M,16612,4962,21574,22.999907295819042
1964,OR,F,12934,792,13726,5.770071397348098
1964,OR,M,11328,4220,15548,27.141754566503728
1964,PA,F,92682,7320,100002,7.319853602927942
1964,PA,M,70099,37169,107268,34.650594771973005
1964,RI,F,7000,582,7582,7.67607491427064
1964,RI,M,4942,3722,8664,42.959372114496766
1964,SC,F,22047,2014,24061,8.370391920535306
1964,SC,M,19849,6722,26571,25.29825749877686
1964,SD,F,5867,383,6250,6.128
1964,SD,M,5017,1738,6755,25.729089563286458
1964,TN,F,32400,2432,34832,6.982085438677078
1964,TN,M,28945,9432,38377,24.577220731167102
1964,TX,F,96466,7818,104284,7.496835564420238
1964,TX,M,85430,27291,112721,24.211105295375308
1964,UT,F,8991,416,9407,4.422238758371425
1964,UT,M,8185,2701,10886,24.81168473268418
1964,VA,F,36719,3142,39861,7.8823913098015606
1964,VA,M,30996,11862,42858,27.67744645107098
1964,VT,F,2991,237,3228,7.342007434944238
1964,VT,M,2384,1292,3676,35.14689880304679
1964,WA,F,22664,1355,24019,5.64136725092635
1964,WA,M,19431,7299,26730,27.306397306397308
1964,WI,F,36908,2697,39605,6.809746244161091
1964,WI,M,28259,14284,42543,33.57544131819571
1964,WV,F,13967,1274,15241,8.35903155960895
1964,WV,M,12151,4965,17116,29.007945781724704
1964,WY,F,2205,144,2349,6.130268199233716
1964,WY,M,1980,849,2829,30.010604453870627
1965,AK,F,2058,234,2292,10.209424083769633
1965,AK,M,2040,940,2980,31.543624161073826
1965,AL,F,27303,2195,29498,7.441182453047664
1965,AL,M,24738,7743,32481,23.838551768726333
1965,AR,F,13925,1007,14932,6.743905705866596
1965,AR,M,13170,3806,16976,22.419886899151745
1965,AZ,F,12417,979,13396,7.308151687070767
1965,AZ,M,11052,4190,15242,27.489830730875216
1965,CA,F,152185,9451,161636,5.847088519884184
1965,CA,M,125542,49474,175016,28.26827261507519
1965,CO,F,14940,973,15913,6.114497580594482
1965,CO,M,12932,5097,18029,28.27111875311997
1965,CT,F,21350,1668,23018,7.246502736988444
1965,CT,M,15630,9406,25036,37.56989934494328
1965,DC,F,10811,886,11697,7.574591775668975
1965,DC,M,8928,4007,12935,30.977966756861232
1965,DE,F,3656,302,3958,7.6301162203132895
1965,DE,M,2943,1617,4560,35.46052631578947
1965,FL,F,41373,3027,44400,6.8175675675675675
1965,FL,M,36071,13572,49643,27.33920190157726
1965,GA,F,38082,2758,40840,6.753183153770813
1965,GA,M,34356,10355,44711,23.15984880678133
1965,HI,F,5166,271,5437,4.984366378517565
1965,HI,M,4812,1886,6698,28.157659002687367
1965,IA,F,20919,1219,22138,5.50636913903695
1965,IA,M,17860,6921,24781,27.928655017957304
1965,ID,F,4450,243,4693,5.1779245685062865
1965,ID,M,4116,1345,5461,24.62918879326131
1965,IL,F,85011,6277,91288,6.876040662518622
1965,IL,M,68354,30527,98881,30.87246285939665
1965,IN,F,40265,2714,42979,6.314711836012936
1965,IN,M,33789,13488,47277,28.529729043721048
1965,KS,F,14552,843,15395,5.475803832413121
1965,KS,M,13084,4331,17415,24.86936548952053
1965,KY,F,24768,2019,26787,7.537238212565797
1965,KY,M,21483,8060,29543,27.28226652675761
1965,LA,F,31237,2180,33417,6.523625699494269
1965,LA,M,28179,8422,36601,23.01030026502008
1965,MA,F,43732,3487,47219,7.38473919396853
1965,MA,M,29819,21252,51071,41.61265688942844
1965,MD,F,26030,2182,28212,7.734297462072877
1965,MD,M,21390,9619,31009,31.020026443935635
1965,ME,F,7701,511,8212,6.222601071602533
1965,ME,M,6095,3145,9240,34.03679653679654
1965,MI,F,69274,4524,73798,6.1302474321797344
1965,MI,M,55071,24759,79830,31.014656144306652
1965,MN,F,29474,1926,31400,6.13375796178344
1965,MN,M,22619,11103,33722,32.925093410829724
1965,MO,F,33956,2478,36434,6.801339408245045
1965,MO,M,28758,11062,39820,27.78001004520341
1965,MS,F,19138,1658,20796,7.972687055202924
1965,MS,M,17571,4912,22483,21.847618200418093
1965,MT,F,4587,276,4863,5.67550894509562
1965,MT,M,4283,1586,5869,27.023342988584087
1965,NC,F,38592,3205,41797,7.668014450797904
1965,NC,M,34442,11163,45605,24.477579212805615
1965,ND,F,4789,282,5071,5.561033326760008
1965,ND,M,4336,1557,5893,26.42117766842016
1965,NE,F,10898,646,11544,5.5959805959805955
1965,NE,M,9177,3646,12823,28.43328394291507
1965,NH,F,4750,294,5044,5.828707375099127
1965,NH,M,3628,2083,5711,36.47347224654176
1965,NJ,F,50226,3604,53830,6.695151402563626
1965,NJ,M,37763,20555,58318,35.24640762714771
1965,NM,F,8954,727,9681,7.509554798058052
1965,NM,M,7924,2914,10838,26.88687949806237
1965,NV,F,2918,194,3112,6.233933161953727
1965,NV,M,2562,1098,3660,30.0
1965,NY,F,143228,10383,153611,6.759281561867314
1965,NY,M,107099,56422,163521,34.504436739012114
1965,OH,F,82253,5795,88048,6.58163728875159
1965,OH,M,65400,28881,94281,30.63289528112769
1965,OK,F,16051,976,17027,5.732072590591414
1965,OK,M,14808,4498,19306,23.298456438412927
1965,OR,F,12712,750,13462,5.571237557569455
1965,OR,M,11369,4033,15402,26.18491105051292
1965,PA,F,86706,6283,92989,6.756713159621031
1965,PA,M,65650,34906,100556,34.71299574366522
1965,RI,F,6829,479,7308,6.554460864805692
1965,RI,M,4959,3354,8313,40.3464453265969
1965,SC,F,20761,1772,22533,7.864021657125106
1965,SC,M,18123,5938,24061,24.67894102489506
1965,SD,F,4908,232,5140,4.5136186770428015
1965,SD,M,4456,1618,6074,26.63812973328943
1965,TN,F,29917,2091,32008,6.532741814546364
1965,TN,M,26349,8663,35012,24.742945275905402
1965,TX,F,89034,6869,95903,7.16244538752698
1965,TX,M,78506,25322,103828,24.388411603806297
1965,UT,F,8280,357,8637,4.133379645710316
1965,UT,M,7631,2491,10122,24.60976091681486
1965,VA,F,33693,2812,36505,7.703054376112862
1965,VA,M,28275,10808,39083,27.653967198014485
1965,VT,F,2717,230,2947,7.804546996946046
1965,VT,M,2260,1141,3401,33.54895618935607
1965,WA,F,20986,1180,22166,5.323468374988721
1965,WA,M,17696,6787,24483,27.72127598741984
1965,WI,F,34276,2356,36632,6.431535269709543
1965,WI,M,26611,13247,39858,33.235485975212
1965,WV,F,12548,1006,13554,7.42216319905563
1965,WV,M,10653,4402,15055,29.239455330455
1965,WY,F,1912,107,2019,5.299653293709757
1965,WY,M,1763,784,2547,30.781311346682372
1966,AK,F,1950,199,2149,9.260120986505353
1966,AK,M,1950,887,2837,31.265421219598167
1966,AL,F,25641,1973,27614,7.144926486564786
1966,AL,M,23221,7307,30528,23.9354035639413
1966,AR,F,13015,923,13938,6.622183957526187
1966,AR,M,12041,3717,15758,23.588018784109657
1966,AZ,F,11875,921,12796,7.197561738043139
1966,AZ,M,10415,3902,14317,27.25431305441084
1966,CA,F,144936,8772,153708,5.706924818487001
1966,CA,M,117975,47796,165771,28.83254610275621
1966,CO,F,14286,884,15170,5.827290705339486
1966,CO,M,11894,4760,16654,28.581722108802687
1966,CT,F,20561,1466,22027,6.655468288918145
1966,CT,M,14999,8847,23846,37.100561939109284
1966,DC,F,10249,757,11006,6.878066509176812
1966,DC,M,8477,4054,12531,32.35176761631155
1966,DE,F,3470,273,3743,7.2936147475287205
1966,DE,M,2766,1571,4337,36.22319575743602
1966,FL,F,40008,2883,42891,6.721689865006645
1966,FL,M,34663,13106,47769,27.436203395507547
1966,GA,F,36081,2601,38682,6.724057701256399
1966,GA,M,32241,10000,42241,23.673681967756448
1966,HI,F,4618,287,4905,5.851172273190622
1966,HI,M,4413,1647,6060,27.17821782178218
1966,IA,F,19907,1172,21079,5.560036054841311
1966,IA,M,16901,6755,23656,28.55512343591478
1966,ID,F,4156,201,4357,4.613266008721598
1966,ID,M,4012,1366,5378,25.399776868724434
1966,IL,F,82409,5548,87957,6.307627590754573
1966,IL,M,66184,29120,95304,30.55485603962058
1966,IN,F,39639,2422,42061,5.7583034164665605
1966,IN,M,32822,12701,45523,27.900182325417923
1966,KS,F,13554,764,14318,5.335940773851097
1966,KS,M,11916,4011,15927,25.183650404972692
1966,KY,F,23056,1773,24829,7.140843368641509
1966,KY,M,20332,7576,27908,27.146337967607852
1966,LA,F,30100,1966,32066,6.1311045967691635
1966,LA,M,27110,8210,35320,23.24462061155153
1966,MA,F,42025,3013,45038,6.68990630134553
1966,MA,M,28515,19826,48341,41.012804865435136
1966,MD,F,25432,1927,27359,7.043386088672832
1966,MD,M,20387,9244,29631,31.197057136107453
1966,ME,F,7267,446,7713,5.782445222351874
1966,ME,M,5547,2783,8330,33.4093637454982
1966,MI,F,69333,4166,73499,5.66810432795004
1966,MI,M,54766,24375,79141,30.79945919308576
1966,MN,F,27626,1727,29353,5.883555343576466
1966,MN,M,21522,10335,31857,32.44184951502025
1966,MO,F,32375,2193,34568,6.344017588521175
1966,MO,M,27432,10885,38317,28.407756348357125
1966,MS,F,17987,1518,19505,7.782619841066393
1966,MS,M,16460,4899,21359,22.93646706306475
1966,MT,F,4269,258,4527,5.699138502319417
1966,MT,M,3785,1524,5309,28.705970992653985
1966,NC,F,36837,2855,39692,7.192885216164465
1966,NC,M,32368,10689,43057,24.825231669647213
1966,ND,F,4378,249,4627,5.381456667387076
1966,ND,M,3948,1488,5436,27.373068432671083
1966,NE,F,10074,507,10581,4.791607598525659
1966,NE,M,8450,3403,11853,28.71003121572598
1966,NH,F,4394,286,4680,6.111111111111111
1966,NH,M,3517,1987,5504,36.10101744186046
1966,NJ,F,48387,3170,51557,6.148534631572822
1966,NJ,M,36551,19549,56100,34.84670231729055
1966,NM,F,8051,645,8696,7.4172033118675245
1966,NM,M,6956,2741,9697,28.26647416726823
1966,NV,F,2752,170,2922,5.817932922655715
1966,NV,M,2322,1045,3367,31.036531036531034
1966,NY,F,136289,9424,145713,6.467508046639628
1966,NY,M,103514,53620,157134,34.12374151997658
1966,OH,F,79853,5323,85176,6.249412980182211
1966,OH,M,64305,28420,92725,30.649770827716367
1966,OK,F,14783,848,15631,5.425116755166017
1966,OK,M,13723,4293,18016,23.8288188277087
1966,OR,F,12573,681,13254,5.1380715255771845
1966,OR,M,10933,4056,14989,27.059843885516045
1966,PA,F,83959,5576,89535,6.227732171776401
1966,PA,M,62551,33041,95592,34.5646079169805
1966,RI,F,6536,434,6970,6.226685796269727
1966,RI,M,4598,3086,7684,40.161374284226966
1966,SC,F,19611,1609,21220,7.582469368520265
1966,SC,M,17134,6011,23145,25.97105206308058
1966,SD,F,4474,256,4730,5.412262156448203
1966,SD,M,3935,1404,5339,26.297059374414683
1966,TN,F,28410,1925,30335,6.345805175539805
1966,TN,M,24992,8451,33443,25.26986215351494
1966,TX,F,85574,6320,91894,6.8774892811282555
1966,TX,M,75773,24610,100383,24.516103324268055
1966,UT,F,8471,350,8821,3.967804103843102
1966,UT,M,7693,2644,10337,25.578020702331433
1966,VA,F,31779,2503,34282,7.3012076308266725
1966,VA,M,26652,10454,37106,28.173341238613702
1966,VT,F,2661,179,2840,6.302816901408451
1966,VT,M,2129,1143,3272,34.93276283618582
1966,WA,F,20270,1102,21372,5.156279243870484
1966,WA,M,17419,6844,24263,28.20755883443927
1966,WI,F,33418,2147,35565,6.036833965977787
1966,WI,M,25661,12656,38317,33.02972570921523
1966,WV,F,11753,857,12610,6.796193497224425
1966,WV,M,10080,4117,14197,28.999084313587375
1966,WY,F,1594,121,1715,7.055393586005831
1966,WY,M,1529,653,2182,29.92667277726856
1967,AK,F,1939,173,2112,8.191287878787879
1967,AK,M,1756,891,2647,33.66074801662259
1967,AL,F,24856,1871,26727,7.000411568825532
1967,AL,M,21949,7388,29337,25.183215734396835
1967,AR,F,12557,899,13456,6.68103448275862
1967,AR,M,11464,3597,15061,23.88287630303433
1967,AZ,F,11820,903,12723,7.0973826927611405
1967,AZ,M,10259,4189,14448,28.993632336655594
1967,CA,F,144648,8260,152908,5.4019410364402125
1967,CA,M,117024,48942,165966,29.489172481110586
1967,CO,F,14426,820,15246,5.37845992391447
1967,CO,M,12351,5082,17433,29.15160901738083
1967,CT,F,19496,1352,20848,6.485034535686876
1967,CT,M,14398,8550,22948,37.2581488582883
1967,DC,F,9938,657,10595,6.201038225578103
1967,DC,M,8380,3891,12271,31.70890717952897
1967,DE,F,3435,261,3696,7.061688311688312
1967,DE,M,2550,1635,4185,39.06810035842294
1967,FL,F,38933,2491,41424,6.013422170722286
1967,FL,M,33473,13136,46609,28.183398056169413
1967,GA,F,34503,2371,36874,6.430004881488312
1967,GA,M,30627,10237,40864,25.051389976507437
1967,HI,F,4522,231,4753,4.860088365243005
1967,HI,M,4316,1720,6036,28.49569251159708
1967,IA,F,19657,987,20644,4.781050184072854
1967,IA,M,16129,6546,22675,28.868798235942666
1967,ID,F,4062,199,4261,4.670265195963389
1967,ID,M,4007,1343,5350,25.102803738317757
1967,IL,F,80438,5006,85444,5.8588081082346335
1967,IL,M,63811,28815,92626,31.108975881501955
1967,IN,F,38453,2280,40733,5.597427147521666
1967,IN,M,31713,13303,45016,29.55171494579705
1967,KS,F,12853,675,13528,4.989651094027202
1967,KS,M,11530,3970,15500,25.61290322580645
1967,KY,F,22896,1703,24599,6.923045652262287
1967,KY,M,19341,7702,27043,28.480567984321265
1967,LA,F,29327,1887,31214,6.045364259627091
1967,LA,M,26272,8282,34554,23.96828153035828
1967,MA,F,40793,2766,43559,6.350008035078858
1967,MA,M,27722,19391,47113,41.15849128690595
1967,MD,F,24098,1695,25793,6.571550420656767
1967,MD,M,19550,9293,28843,32.21925597198627
1967,ME,F,6897,441,7338,6.0098119378577275
1967,ME,M,5349,2775,8124,34.15805022156573
1967,MI,F,67556,3696,71252,5.187222814798181
1967,MI,M,53324,24465,77789,31.45046214760442
1967,MN,F,26735,1422,28157,5.050253933302554
1967,MN,M,20509,10199,30708,33.212843558681776
1967,MO,F,31471,2049,33520,6.112768496420048
1967,MO,M,26133,10492,36625,28.647098976109213
1967,MS,F,17237,1445,18682,7.734717910287977
1967,MS,M,15770,4840,20610,23.483745754488112
1967,MT,F,4075,221,4296,5.144320297951583
1967,MT,M,3630,1502,5132,29.267342166796574
1967,NC,F,36625,2790,39415,7.078523404795129
1967,NC,M,31917,11094,43011,25.793401687940293
1967,ND,F,4122,193,4315,4.472769409038238
1967,ND,M,3574,1297,4871,26.626975980291522
1967,NE,F,9490,449,9939,4.517557098299628
1967,NE,M,7927,3212,11139,28.835622587305863
1967,NH,F,4400,299,4699,6.363055969355182
1967,NH,M,3494,2013,5507,36.55347739240966
1967,NJ,F,46515,3110,49625,6.267002518891688
1967,NJ,M,35057,18904,53961,35.03270880821334
1967,NM,F,7470,611,8081,7.560945427546095
1967,NM,M,6504,2536,9040,28.053097345132745
1967,NV,F,2519,157,2676,5.866965620328849
1967,NV,M,2373,1032,3405,30.30837004405286
1967,NY,F,130612,8782,139394,6.300127695596654
1967,NY,M,99011,51568,150579,34.2464752721163
1967,OH,F,77822,4889,82711,5.910942921739551
1967,OH,M,61620,28348,89968,31.508980971011912
1967,OK,F,14772,812,15584,5.210472279260781
1967,OK,M,13428,4488,17916,25.050234427327528
1967,OR,F,12139,648,12787,5.067646828810511
1967,OR,M,10644,4148,14792,28.042184964845863
1967,PA,F,80393,5014,85407,5.870713173393281
1967,PA,M,59862,32341,92203,35.075865210459526
1967,RI,F,6291,412,6703,6.146501566462778
1967,RI,M,4498,3073,7571,40.58908994848765
1967,SC,F,19012,1478,20490,7.213274768179599
1967,SC,M,16783,5864,22647,25.89305426767342
1967,SD,F,4105,205,4310,4.756380510440835
1967,SD,M,3429,1300,4729,27.489955593148657
1967,TN,F,28027,1884,29911,6.298686102102906
1967,TN,M,24161,8624,32785,26.304712520969957
1967,TX,F,85892,6085,91977,6.6157843808778285
1967,TX,M,74583,25626,100209,25.572553363470345
1967,UT,F,8573,375,8948,4.190880643719267
1967,UT,M,7655,2740,10395,26.35882635882636
1967,VA,F,31197,2286,33483,6.827345219962369
1967,VA,M,25935,10445,36380,28.7108301264431
1967,VT,F,2523,173,2696,6.416913946587536
1967,VT,M,2137,1135,3272,34.68826405867971
1967,WA,F,21515,1143,22658,5.044575867243357
1967,WA,M,18259,7320,25579,28.617225067438135
1967,WI,F,31574,1773,33347,5.316820103757459
1967,WI,M,24228,11982,36210,33.090306545153275
1967,WV,F,11554,775,12329,6.28599237569957
1967,WV,M,9427,4081,13508,30.211726384364823
1967,WY,F,1544,75,1619,4.632489190858554
1967,WY,M,1435,667,2102,31.731684110371077
1968,AK,F,1963,154,2117,7.274444969296173
1968,AK,M,1812,921,2733,33.69923161361142
1968,AL,F,24478,1636,26114,6.264838783794133
1968,AL,M,21606,7407,29013,25.529934856788337
1968,AR,F,12234,762,12996,5.863342566943675
1968,AR,M,11305,3618,14923,24.244454868324063
1968,AZ,F,12115,824,12939,6.368343766906253
1968,AZ,M,10323,4168,14491,28.762680284314403
1968,CA,F,145777,7990,153767,5.196173431230368
1968,CA,M,117699,49619,167318,29.655506281452087
1968,CO,F,14800,761,15561,4.89043120622068
1968,CO,M,12611,5228,17839,29.30657548068838
1968,CT,F,19079,1258,20337,6.1857697792201405
1968,CT,M,14080,8381,22461,37.313565736164904
1968,DC,F,9455,623,10078,6.181782099622941
1968,DC,M,8074,3794,11868,31.968318166498143
1968,DE,F,3359,233,3592,6.486636971046771
1968,DE,M,2651,1583,4234,37.387812942843645
1968,FL,F,39753,2501,42254,5.918966251715814
1968,FL,M,33973,13590,47563,28.572629985492924
1968,GA,F,35522,2133,37655,5.664586376311247
1968,GA,M,30575,10429,41004,25.434103989854652
1968,HI,F,4357,213,4570,4.660831509846827
1968,HI,M,4161,1709,5870,29.11413969335605
1968,IA,F,19151,938,20089,4.669221962267907
1968,IA,M,15971,6571,22542,29.15003105314524
1968,ID,F,4194,203,4397,4.616784171025699
1968,ID,M,3883,1474,5357,27.51540041067762
1968,IL,F,78859,4797,83656,5.734197188486181
1968,IL,M,62651,28662,91313,31.38873982894002
1968,IN,F,37709,2084,39793,5.237102002864826
1968,IN,M,30954,12985,43939,29.552333917476503
1968,KS,F,13169,634,13803,4.59320437586032
1968,KS,M,11318,4170,15488,26.924070247933884
1968,KY,F,22432,1533,23965,6.3968287085332785
1968,KY,M,19343,7801,27144,28.73931623931624
1968,LA,F,28665,1639,30304,5.408526927138332
1968,LA,M,26148,8255,34403,23.99500043600849
1968,MA,F,39159,2467,41626,5.92658434632201
1968,MA,M,26986,18640,45626,40.853899092622626
1968,MD,F,23712,1565,25277,6.191399295802508
1968,MD,M,18778,9028,27806,32.46781270229447
1968,ME,F,6492,370,6862,5.392013990090352
1968,ME,M,5041,2672,7713,34.642810838843516
1968,MI,F,66047,3393,69440,4.886232718894009
1968,MI,M,52224,24012,76236,31.496930583976074
1968,MN,F,26687,1427,28114,5.075762965070783
1968,MN,M,20650,10303,30953,33.28594966562207
1968,MO,F,31140,1757,32897,5.340912545216889
1968,MO,M,25934,10636,36570,29.083948591741866
1968,MS,F,16777,1265,18042,7.011417802904334
1968,MS,M,15282,4875,20157,24.185146599196308
1968,MT,F,3980,209,4189,4.989257579374552
1968,MT,M,3597,1397,4994,27.973568281938327
1968,NC,F,36810,2478,39288,6.307269395235187
1968,NC,M,32128,11325,43453,26.062642395231627
1968,ND,F,3875,207,4082,5.071043606075453
1968,ND,M,3615,1324,4939,26.807045960720792
1968,NE,F,9515,425,9940,4.275653923541248
1968,NE,M,7768,3322,11090,29.95491433724076
1968,NH,F,4485,266,4751,5.598821300778783
1968,NH,M,3398,1923,5321,36.13982334147717
1968,NJ,F,45498,2719,48217,5.63908994752888
1968,NJ,M,34108,18557,52665,35.235925187505934
1968,NM,F,7071,593,7664,7.737473903966598
1968,NM,M,6237,2573,8810,29.20544835414302
1968,NV,F,2481,125,2606,4.796623177283193
1968,NV,M,2260,1111,3371,32.95757935330762
1968,NY,F,128183,7940,136123,5.8329598965641365
1968,NY,M,96932,50906,147838,34.43363681867991
1968,OH,F,78169,4420,82589,5.351802298126869
1968,OH,M,61572,28751,90323,31.831316497459117
1968,OK,F,15202,778,15980,4.868585732165206
1968,OK,M,13724,4591,18315,25.06688506688507
1968,OR,F,12508,601,13109,4.584636509268441
1968,OR,M,10617,4331,14948,28.973775755953973
1968,PA,F,79583,4623,84206,5.490107593283139
1968,PA,M,59035,31606,90641,34.86942994891936
1968,RI,F,6039,349,6388,5.463368816530996
1968,RI,M,4194,2927,7121,41.103777559331554
1968,SC,F,18906,1413,20319,6.954082385944191
1968,SC,M,16505,5893,22398,26.310384855790698
1968,SD,F,3888,173,4061,4.260034474267422
1968,SD,M,3482,1363,4845,28.132094943240453
1968,TN,F,27408,1752,29160,6.008230452674898
1968,TN,M,23788,8821,32609,27.050814192400868
1968,TX,F,87951,5969,93920,6.355408858603067
1968,TX,M,76040,26452,102492,25.80884361706279
1968,UT,F,8690,333,9023,3.690568547046437
1968,UT,M,7569,2899,10468,27.693924340848298
1968,VA,F,30930,2057,32987,6.23578985661018
1968,VA,M,25647,10870,36517,29.7669578552455
1968,VT,F,2565,141,2706,5.210643015521065
1968,VT,M,1995,1126,3121,36.07818007049023
1968,WA,F,22497,1013,23510,4.308804763930243
1968,WA,M,18943,7665,26608,28.807125676488276
1968,WI,F,30901,1663,32564,5.106866478319617
1968,WI,M,23659,11805,35464,33.28727723889014
1968,WV,F,11420,768,12188,6.301279947489334
1968,WV,M,9434,4304,13738,31.329159994176734
1968,WY,F,1561,100,1661,6.020469596628537
1968,WY,M,1479,719,2198,32.711555959963604
1969,AK,F,2236,168,2404,6.988352745424292
1969,AK,M,1910,1004,2914,34.454358270418666
1969,AL,F,24503,1652,26155,6.3161919327088505
1969,AL,M,21638,7881,29519,26.698058877333242
1969,AR,F,12722,797,13519,5.8954064649752205
1969,AR,M,11470,3813,15283,24.94929006085193
1969,AZ,F,12563,878,13441,6.532252064578528
1969,AZ,M,10896,4643,15539,29.87965763562649
1969,CA,F,151758,8106,159864,5.070559975979583
1969,CA,M,121417,52565,173982,30.212895586899798
1969,CO,F,15557,772,16329,4.727784922530468
1969,CO,M,13050,5549,18599,29.834937362223773
1969,CT,F,19753,1204,20957,5.745097103593071
1969,CT,M,14188,8485,22673,37.423367000396944
1969,DC,F,9623,577,10200,5.6568627450980395
1969,DC,M,8187,3793,11980,31.66110183639399
1969,DE,F,3437,202,3639,5.5509755427315195
1969,DE,M,2809,1553,4362,35.602934433745986
1969,FL,F,41937,2458,44395,5.536659533731276
1969,FL,M,35728,14652,50380,29.08296943231441
1969,GA,F,36018,2170,38188,5.682413323557138
1969,GA,M,31399,11415,42814,26.661839585182417
1969,HI,F,4720,234,4954,4.723455793298345
1969,HI,M,4575,1855,6430,28.849144634525658
1969,IA,F,19467,906,20373,4.447062288322781
1969,IA,M,15897,6781,22678,29.90122585765941
1969,ID,F,4297,193,4490,4.298440979955457
1969,ID,M,3977,1575,5552,28.368155619596543
1969,IL,F,80081,4681,84762,5.522521884806872
1969,IL,M,63292,28851,92143,31.311114246334505
1969,IN,F,38784,2125,40909,5.194455987679972
1969,IN,M,31470,13604,45074,30.181479345076983
1969,KS,F,13633,698,14331,4.8705603237736375
1969,KS,M,11921,4508,16429,27.439284192586282
1969,KY,F,23155,1527,24682,6.186694757313021
1969,KY,M,19535,8029,27564,29.128573501668843
1969,LA,F,29144,1638,30782,5.321291663959457
1969,LA,M,25906,8296,34202,24.255891468335186
1969,MA,F,39833,2432,42265,5.754170117118183
1969,MA,M,27315,18665,45980,40.593736407133534
1969,MD,F,23622,1476,25098,5.8809466889792015
1969,MD,M,19200,9229,28429,32.46332969854726
1969,ME,F,6616,384,7000,5.485714285714286
1969,ME,M,5115,2661,7776,34.22067901234568
1969,MI,F,68318,3387,71705,4.723519977686354
1969,MI,M,53802,24419,78221,31.217959371524273
1969,MN,F,27440,1313,28753,4.566480019476229
1969,MN,M,20923,10591,31514,33.60728565082186
1969,MO,F,32434,1847,34281,5.387824159155217
1969,MO,M,27197,11383,38580,29.50492483151892
1969,MS,F,17370,1230,18600,6.612903225806452
1969,MS,M,15807,5118,20925,24.45878136200717
1969,MT,F,3819,202,4021,5.023625963690624
1969,MT,M,3490,1476,4966,29.722110350382604
1969,NC,F,37365,2473,39838,6.207640945830614
1969,NC,M,32028,11948,43976,27.169365108240857
1969,ND,F,4115,179,4294,4.168607359105729
1969,ND,M,3531,1468,4999,29.365873174634928
1969,NE,F,9696,388,10084,3.8476794922649744
1969,NE,M,8058,3432,11490,29.869451697127936
1969,NH,F,4572,247,4819,5.125544718821332
1969,NH,M,3498,2157,5655,38.14323607427056
1969,NJ,F,46854,2703,49557,5.454325322356075
1969,NJ,M,35441,18584,54025,34.39888940305414
1969,NM,F,7560,488,8048,6.063618290258449
1969,NM,M,6620,2689,9309,28.886024277580834
1969,NV,F,2638,146,2784,5.244252873563219
1969,NV,M,2330,1239,3569,34.715606612496494
1969,NY,F,131016,7846,138862,5.65021388140744
1969,NY,M,99449,51832,151281,34.262068600815695
1969,OH,F,79880,4393,84273,5.212820238985203
1969,OH,M,62680,29632,92312,32.09983534101742
1969,OK,F,15834,821,16655,4.9294506154308015
1969,OK,M,14344,5020,19364,25.92439578599463
1969,OR,F,13155,634,13789,4.597867865690042
1969,OR,M,11022,4730,15752,30.027932960893857
1969,PA,F,79425,4297,83722,5.13246219631638
1969,PA,M,58790,31884,90674,35.16333237752829
1969,RI,F,6062,315,6377,4.939626783754116
1969,RI,M,4366,2942,7308,40.257252326217845
1969,SC,F,18823,1361,20184,6.742964724534286
1969,SC,M,16606,6073,22679,26.77807663477226
1969,SD,F,3999,165,4164,3.962536023054755
1969,SD,M,3461,1380,4841,28.506506920057838
1969,TN,F,28639,1760,30399,5.789664133688608
1969,TN,M,24676,9428,34104,27.64485104386582
1969,TX,F,94307,6240,100547,6.206052890687936
1969,TX,M,80802,28519,109321,26.08739400481152
1969,UT,F,9048,352,9400,3.74468085106383
1969,UT,M,7910,3150,11060,28.48101265822785
1969,VA,F,31368,2022,33390,6.05570530098832
1969,VA,M,25911,11119,37030,30.02700513097489
1969,VT,F,2707,146,2853,5.117420259376095
1969,VT,M,2125,1151,3276,35.134310134310134
1969,WA,F,23173,1142,24315,4.696689286448694
1969,WA,M,19251,8277,27528,30.067567567567565
1969,WI,F,30994,1547,32541,4.754002642819827
1969,WI,M,23707,11647,35354,32.943938451094645
1969,WV,F,11151,726,11877,6.112654710785552
1969,WV,M,9425,4173,13598,30.688336520076483
1969,WY,F,1612,65,1677,3.875968992248062
1969,WY,M,1594,714,2308,30.935875216637783
1970,AK,F,2461,205,2666,7.689422355588897
1970,AK,M,2068,1110,3178,34.927627438640656
1970,AL,F,25557,1559,27116,5.749373063873728
1970,AL,M,22387,8503,30890,27.526707672385886
1970,AR,F,12858,768,13626,5.6362835755173935
1970,AR,M,11810,4239,16049,26.412860614368494
1970,AZ,F,14083,869,14952,5.811931514178705
1970,AZ,M,11971,5038,17009,29.61961314598154
1970,CA,F,155784,8258,164042,5.034076638909547
1970,CA,M,123261,55288,178549,30.96516922525469
1970,CO,F,16468,754,17222,4.378121008013006
1970,CO,M,13721,6098,19819,30.768454513345777
1970,CT,F,19611,1152,20763,5.548331166016472
1970,CT,M,14499,8641,23140,37.34226447709594
1970,DC,F,9426,552,9978,5.532170775706555
1970,DC,M,8372,3763,12135,31.00947672023074
1970,DE,F,3548,211,3759,5.613194998669859
1970,DE,M,2789,1693,4482,37.77331548415886
1970,FL,F,45211,2427,47638,5.094672320416474
1970,FL,M,38098,15767,53865,29.27132646430892
1970,GA,F,38239,2195,40434,5.4285996933273974
1970,GA,M,32771,12398,45169,27.448028515132062
1970,HI,F,4938,226,5164,4.376452362509682
1970,HI,M,4627,2018,6645,30.36869826937547
1970,IA,F,20036,854,20890,4.088080421254189
1970,IA,M,16266,6892,23158,29.760773814664475
1970,ID,F,4691,178,4869,3.6557814746354484
1970,ID,M,4361,1758,6119,28.730184670697827
1970,IL,F,83257,4456,87713,5.080204758701675
1970,IL,M,66543,30302,96845,31.28917342144664
1970,IN,F,40944,2138,43082,4.962629404391626
1970,IN,M,33008,14767,47775,30.909471480900052
1970,KS,F,14116,636,14752,4.311279826464208
1970,KS,M,11880,4767,16647,28.635790232474317
1970,KY,F,24463,1523,25986,5.860848149003309
1970,KY,M,20329,8606,28935,29.742526352168653
1970,LA,F,28820,1593,30413,5.237891691053168
1970,LA,M,25642,8239,33881,24.31746406540539
1970,MA,F,39974,2276,42250,5.38698224852071
1970,MA,M,28102,18548,46650,39.759914255091104
1970,MD,F,23830,1390,25220,5.511498810467883
1970,MD,M,19061,9091,28152,32.292554703040636
1970,ME,F,6823,341,7164,4.759910664433278
1970,ME,M,5187,2748,7935,34.63137996219282
1970,MI,F,70744,3339,74083,4.507106893619319
1970,MI,M,55851,25562,81413,31.397933990885978
1970,MN,F,28230,1354,29584,4.576798269334775
1970,MN,M,21456,11261,32717,34.41941498303634
1970,MO,F,33676,1796,35472,5.063148398737032
1970,MO,M,27731,11892,39623,30.0128713121167
1970,MS,F,17546,1248,18794,6.640417154410983
1970,MS,M,15966,5271,21237,24.819889814945615
1970,MT,F,4147,190,4337,4.380908462070556
1970,MT,M,3753,1544,5297,29.148574664904665
1970,NC,F,39408,2485,41893,5.9317785787601744
1970,NC,M,33203,12420,45623,27.223111150077813
1970,ND,F,4260,137,4397,3.1157607459631564
1970,ND,M,3550,1577,5127,30.75872830115077
1970,NE,F,10016,406,10422,3.8956054500095947
1970,NE,M,8306,3694,12000,30.783333333333335
1970,NH,F,4800,278,5078,5.4745962977550215
1970,NH,M,3739,2084,5823,35.789112141507815
1970,NJ,F,47649,2581,50230,5.138363527772247
1970,NJ,M,36369,19037,55406,34.35909468288633
1970,NM,F,7656,560,8216,6.815968841285297
1970,NM,M,6771,2822,9593,29.41728343583863
1970,NV,F,2829,131,2960,4.425675675675675
1970,NV,M,2516,1300,3816,34.067085953878404
1970,NY,F,133383,7932,141315,5.61299225135336
1970,NY,M,102342,52373,154715,33.85127492486184
1970,OH,F,84718,4428,89146,4.96713256904404
1970,OH,M,66022,30988,97010,31.943098649623753
1970,OK,F,16819,799,17618,4.53513452151209
1970,OK,M,14908,5334,20242,26.351151072028458
1970,OR,F,13714,663,14377,4.611532308548376
1970,OR,M,11415,5199,16614,31.29288551823763
1970,PA,F,81825,4114,85939,4.787116443058449
1970,PA,M,61280,32786,94066,34.85425127038462
1970,RI,F,6062,341,6403,5.325628611588318
1970,RI,M,4451,2973,7424,40.0457974137931
1970,SC,F,19236,1323,20559,6.435137895812053
1970,SC,M,17020,6354,23374,27.184050654573454
1970,SD,F,4102,177,4279,4.136480486094881
1970,SD,M,3560,1520,5080,29.92125984251969
1970,TN,F,29665,1824,31489,5.79249896789355
1970,TN,M,25310,10017,35327,28.355082514790386
1970,TX,F,97926,6302,104228,6.046359903288943
1970,TX,M,84285,30406,114691,26.51123453453192
1970,UT,F,10124,383,10507,3.645188921671267
1970,UT,M,8585,3764,12349,30.48020082597781
1970,VA,F,32405,2013,34418,5.848683828229414
1970,VA,M,26829,11486,38315,29.977815476967244
1970,VT,F,2774,156,2930,5.324232081911263
1970,VT,M,2208,1331,3539,37.60949420740322
1970,WA,F,23535,1085,24620,4.406986190089358
1970,WA,M,19484,8722,28206,30.92249875912926
1970,WI,F,32144,1530,33674,4.543564768070321
1970,WI,M,24417,12370,36787,33.62600918802838
1970,WV,F,12083,721,12804,5.63105279600125
1970,WV,M,9595,4430,14025,31.58645276292335
1970,WY,F,1884,75,1959,3.828483920367534
1970,WY,M,1706,813,2519,32.27471218737594
1971,AK,F,2287,174,2461,7.07029662738724
1971,AK,M,2104,1086,3190,34.043887147335425
1971,AL,F,25065,1512,26577,5.689129698611581
1971,AL,M,22011,8176,30187,27.084506575678276
1971,AR,F,13239,671,13910,4.823867721063983
1971,AR,M,11727,4214,15941,26.434978985007213
1971,AZ,F,14244,848,15092,5.618870924993374
1971,AZ,M,12170,5335,17505,30.477006569551556
1971,CA,F,140640,7731,148371,5.210586974543543
1971,CA,M,111703,50100,161803,30.963579167258953
1971,CO,F,15692,795,16487,4.8219809546915755
1971,CO,M,13178,5913,19091,30.972709653763552
1971,CT,F,17432,1024,18456,5.548331166016472
1971,CT,M,12873,7770,20643,37.639877924720246
1971,DC,F,8302,501,8803,5.6912416221742586
1971,DC,M,7402,3387,10789,31.39308555009732
1971,DE,F,3286,182,3468,5.2479815455594
1971,DE,M,2613,1647,4260,38.66197183098591
1971,FL,F,45360,2399,47759,5.023137000355954
1971,FL,M,38268,15613,53881,28.97681928694716
1971,GA,F,36750,2086,38836,5.371304974765681
1971,GA,M,32026,11848,43874,27.004604093540596
1971,HI,F,4500,224,4724,4.741744284504657
1971,HI,M,4417,1819,6236,29.169339320076972
1971,IA,F,18541,743,19284,3.8529350757104335
1971,IA,M,15052,6453,21505,30.006975122064638
1971,ID,F,4667,219,4886,4.482194023741302
1971,ID,M,4096,1799,5895,30.51738761662426
1971,IL,F,78596,4066,82662,4.918826062761608
1971,IL,M,63072,28002,91074,30.746425983266356
1971,IN,F,39187,1930,41117,4.693922221951991
1971,IN,M,31603,14271,45874,31.109124994550292
1971,KS,F,12941,590,13531,4.360357697139901
1971,KS,M,11217,4583,15800,29.00632911392405
1971,KY,F,24446,1530,25976,5.890052356020942
1971,KY,M,20664,8491,29155,29.123649459783913
1971,LA,F,27695,1440,29135,4.942509009782049
1971,LA,M,25220,7882,33102,23.811250075524136
1971,MA,F,37082,2062,39144,5.26772940936031
1971,MA,M,25962,16659,42621,39.08636587597663
1971,MD,F,22191,1260,23451,5.372905206600998
1971,MD,M,18044,8482,26526,31.97617431953555
1971,ME,F,6760,342,7102,4.81554491692481
1971,ME,M,5290,2747,8037,34.17942018165982
1971,MI,F,66071,2931,69002,4.247702965131445
1971,MI,M,53059,23476,76535,30.6735480499118
1971,MN,F,25929,1143,27072,4.222074468085106
1971,MN,M,19663,10047,29710,33.81689666778862
1971,MO,F,32394,1788,34182,5.2308232403019135
1971,MO,M,26834,11444,38278,29.89706881237264
1971,MS,F,17505,1141,18646,6.119274911509171
1971,MS,M,16122,5205,21327,24.40568293712196
1971,MT,F,3987,188,4175,4.502994011976048
1971,MT,M,3587,1568,5155,30.417070805043643
1971,NC,F,38027,2239,40266,5.560522525207371
1971,NC,M,32628,11916,44544,26.751077586206897
1971,ND,F,3933,170,4103,4.143309773336583
1971,ND,M,3320,1502,4822,31.14890087100788
1971,NE,F,10184,413,10597,3.8973294328583563
1971,NE,M,7997,3487,11484,30.3639846743295
1971,NH,F,4669,239,4908,4.86960065199674
1971,NH,M,3621,2114,5735,36.861377506538794
1971,NJ,F,44170,2231,46401,4.808086032628607
1971,NJ,M,34136,17505,51641,33.89748455684437
1971,NM,F,7877,519,8396,6.18151500714626
1971,NM,M,6813,2835,9648,29.384328358208954
1971,NV,F,2822,150,2972,5.0471063257065945
1971,NV,M,2495,1263,3758,33.608302288451306
1971,NY,F,118315,6763,125078,5.407026015766162
1971,NY,M,91314,45814,137128,33.40966104661338
1971,OH,F,79653,4024,83677,4.808967816723831
1971,OH,M,62957,29283,92240,31.746530789245448
1971,OK,F,16905,740,17645,4.193822612638141
1971,OK,M,14872,5368,20240,26.521739130434785
1971,OR,F,12752,607,13359,4.54375327494573
1971,OR,M,10547,5125,15672,32.701633486472694
1971,PA,F,76687,3643,80330,4.535042947840159
1971,PA,M,58315,30109,88424,34.05071021442143
1971,RI,F,5676,304,5980,5.083612040133779
1971,RI,M,4101,2633,6734,39.1000891000891
1971,SC,F,19536,1200,20736,5.787037037037037
1971,SC,M,17285,6142,23427,26.217612156912963
1971,SD,F,4005,177,4182,4.232424677187948
1971,SD,M,3434,1435,4869,29.472170876976794
1971,TN,F,29317,1801,31118,5.787647021016775
1971,TN,M,24882,9713,34595,28.07631160572337
1971,TX,F,97820,6047,103867,5.821868350871788
1971,TX,M,83542,30631,114173,26.82858469165214
1971,UT,F,10395,395,10790,3.66079703429101
1971,UT,M,8580,3949,12529,31.5188762071993
1971,VA,F,31239,1845,33084,5.576713819368879
1971,VA,M,25582,11204,36786,30.45723916707443
1971,VT,F,2662,155,2817,5.502307419240326
1971,VT,M,2115,1185,3300,35.90909090909091
1971,WA,F,21317,1021,22338,4.570686722177456
1971,WA,M,17275,8096,25371,31.910448937763586
1971,WI,F,29575,1336,30911,4.322085988806574
1971,WI,M,22662,11254,33916,33.181979006958365
1971,WV,F,12305,724,13029,5.556834753242766
1971,WV,M,9917,4531,14448,31.36074197120709
1971,WY,F,1675,65,1740,3.7356321839080464
1971,WY,M,1565,773,2338,33.06244653550043
1972,AK,F,1953,143,2096,6.822519083969465
1972,AK,M,1641,1056,2697,39.15461624026697
1972,AL,F,22917,1239,24156,5.129160457029309
1972,AL,M,20157,7502,27659,27.123178712173253
1972,AR,F,12434,663,13097,5.0622279911430095
1972,AR,M,10908,4061,14969,27.12940076157392
1972,AZ,F,13689,805,14494,5.554022354077549
1972,AZ,M,11655,5329,16984,31.376589731512013
1972,CA,F,129979,7085,137064,5.169118076227164
1972,CA,M,103180,47150,150330,31.36433180336593
1972,CO,F,14976,768,15744,4.878048780487805
1972,CO,M,12420,5723,18143,31.543846111447944
1972,CT,F,14961,861,15822,5.441789912779674
1972,CT,M,11177,6670,17847,37.37322799350031
1972,DC,F,6986,419,7405,5.658338960162053
1972,DC,M,6312,3039,9351,32.499197946743664
1972,DE,F,2867,195,3062,6.368386675375572
1972,DE,M,2305,1394,3699,37.68586104352528
1972,FL,F,42466,2027,44493,4.555772818196121
1972,FL,M,35736,14844,50580,29.347568208778174
1972,GA,F,34206,1775,35981,4.933159167338317
1972,GA,M,29376,11217,40593,27.63284310102727
1972,HI,F,4262,186,4448,4.181654676258993
1972,HI,M,4273,1777,6050,29.37190082644628
1972,IA,F,16723,717,17440,4.111238532110092
1972,IA,M,13196,5978,19174,31.177636382601438
1972,ID,F,4533,210,4743,4.427577482605946
1972,ID,M,3980,1867,5847,31.93090473747221
1972,IL,F,71057,3514,74571,4.712287618511217
1972,IL,M,56958,25843,82801,31.21097571285371
1972,IN,F,35220,1818,37038,4.908472379718128
1972,IN,M,28542,13113,41655,31.48001440403313
1972,KS,F,11804,521,12325,4.227180527383368
1972,KS,M,10249,4120,14369,28.672837358201686
1972,KY,F,22438,1313,23751,5.528188286808977
1972,KY,M,18705,7839,26544,29.532097649186255
1972,LA,F,25308,1227,26535,4.62408140192199
1972,LA,M,23678,7566,31244,24.215849443093074
1972,MA,F,32473,1739,34212,5.083011808722086
1972,MA,M,22935,14743,37678,39.12893465682892
1972,MD,F,19568,1028,20596,4.991260438920179
1972,MD,M,15979,7665,23644,32.418372525799356
1972,ME,F,6194,351,6545,5.3628724216959505
1972,ME,M,4722,2561,7283,35.164080735960454
1972,MI,F,59291,2594,61885,4.191645794619051
1972,MI,M,47010,21937,68947,31.817192916298026
1972,MN,F,22958,1108,24066,4.604005651126069
1972,MN,M,17531,9271,26802,34.590702186404
1972,MO,F,29742,1541,31283,4.925998145957868
1972,MO,M,24385,10779,35164,30.65350927084518
1972,MS,F,16327,1009,17336,5.820258421781264
1972,MS,M,14891,5030,19921,25.2497364590131
1972,MT,F,3713,165,3878,4.254770500257865
1972,MT,M,3233,1432,4665,30.69667738478028
1972,NC,F,34821,1900,36721,5.1741510307453495
1972,NC,M,30362,11275,41637,27.079280447678748
1972,ND,F,3807,151,3958,3.8150581101566448
1972,ND,M,3219,1407,4626,30.41504539559014
1972,NE,F,9021,333,9354,3.559974342527261
1972,NE,M,7449,3361,10810,31.09158186864015
1972,NH,F,4232,217,4449,4.877500561924028
1972,NH,M,3170,1964,5134,38.254772107518505
1972,NJ,F,38707,2008,40715,4.931843300994719
1972,NJ,M,30193,15724,45917,34.24439749983666
1972,NM,F,7172,467,7639,6.113365623772745
1972,NM,M,6162,2689,8851,30.380747938086095
1972,NV,F,2611,124,2735,4.53382084095064
1972,NV,M,2147,1272,3419,37.203860778005264
1972,NY,F,104890,5861,110751,5.292051539038022
1972,NY,M,81058,40852,121910,33.5099663686326
1972,OH,F,70961,3468,74429,4.659474129707506
1972,OH,M,55033,26394,81427,32.41430974983728
1972,OK,F,15638,673,16311,4.126049904972104
1972,OK,M,13715,5206,18921,27.51440198720998
1972,OR,F,12023,606,12629,4.798479689603294
1972,OR,M,9576,4989,14565,34.25334706488157
1972,PA,F,68767,3362,72129,4.6610933189147215
1972,PA,M,51900,27373,79273,34.53004175444351
1972,RI,F,4948,231,5179,4.460320525197915
1972,RI,M,3524,2512,6036,41.61696487740225
1972,SC,F,18162,1045,19207,5.440724735773416
1972,SC,M,15936,5850,21786,26.85210685761498
1972,SD,F,3698,125,3823,3.2696834946377193
1972,SD,M,3124,1329,4453,29.84504828205704
1972,TN,F,26792,1516,28308,5.355376571993783
1972,TN,M,22923,9218,32141,28.67987928191407
1972,TX,F,90817,5549,96366,5.758254986198452
1972,TX,M,77406,29134,106540,27.34559789750329
1972,UT,F,10125,416,10541,3.946494639977232
1972,UT,M,8239,3893,12132,32.088691064952194
1972,VA,F,28015,1606,29621,5.421829107727626
1972,VA,M,23126,10353,33479,30.923862719913974
1972,VT,F,2368,122,2490,4.899598393574297
1972,VT,M,1808,1172,2980,39.328859060402685
1972,WA,F,18250,943,19193,4.913249622258116
1972,WA,M,14605,7225,21830,33.09665597801191
1972,WI,F,26327,1187,27514,4.314167332994112
1972,WI,M,20111,10300,30411,33.86932360001315
1972,WV,F,11507,679,12186,5.57196783193829
1972,WV,M,9470,4366,13836,31.55536282162475
1972,WY,F,1663,73,1736,4.205069124423963
1972,WY,M,1452,719,2171,33.11837862736066
1973,AK,F,1865,116,1981,5.85562847046946
1973,AK,M,1465,992,2457,40.374440374440375
1973,AL,F,21792,1177,22969,5.124297966824851
1973,AL,M,19024,7604,26628,28.556406789845273
1973,AR,F,11795,663,12458,5.32188152191363
1973,AR,M,10726,4293,15019,28.583793861109264
1973,AZ,F,13924,868,14792,5.8680367766360195
1973,AZ,M,11556,5686,17242,32.97761280593899
1973,CA,F,123918,6879,130797,5.259294937957293
1973,CA,M,97487,46922,144409,32.4924346820489
1973,CO,F,14920,729,15649,4.65844462904978
1973,CO,M,11693,6421,18114,35.447719995583526
1973,CT,F,13911,785,14696,5.341589548176374
1973,CT,M,10031,6732,16763,40.15987591719859
1973,DC,F,6070,326,6396,5.0969355847404625
1973,DC,M,5584,2773,8357,33.181763790834026
1973,DE,F,2561,138,2699,5.11300481659874
1973,DE,M,2077,1299,3376,38.47748815165877
1973,FL,F,40921,2033,42954,4.732970154118359
1973,FL,M,34437,15167,49604,30.576163212644143
1973,GA,F,32369,1704,34073,5.001027206292372
1973,GA,M,27932,11221,39153,28.659361990141242
1973,HI,F,4314,215,4529,4.747184809008611
1973,HI,M,4044,1826,5870,31.10732538330494
1973,IA,F,15580,718,16298,4.405448521290956
1973,IA,M,12034,6131,18165,33.75172034131572
1973,ID,F,4624,224,4848,4.62046204620462
1973,ID,M,3980,1964,5944,33.04172274562584
1973,IL,F,66752,3454,70206,4.919807423866906
1973,IL,M,52671,25412,78083,32.54485611464724
1973,IN,F,33735,1725,35460,4.864636209813875
1973,IN,M,26226,13534,39760,34.03923541247485
1973,KS,F,11472,500,11972,4.17641162712997
1973,KS,M,9333,4492,13825,32.491862567811935
1973,KY,F,21969,1228,23197,5.293787989826271
1973,KY,M,17724,8066,25790,31.27568825126018
1973,LA,F,24544,1134,25678,4.416231793753408
1973,LA,M,22303,7441,29744,25.01681011296396
1973,MA,F,29980,1711,31691,5.399009182417721
1973,MA,M,20957,14304,35261,40.5660644905136
1973,MD,F,17930,889,18819,4.723949200276317
1973,MD,M,14292,7266,21558,33.704425271360975
1973,ME,F,5618,324,5942,5.4527095254123195
1973,ME,M,4356,2641,6997,37.7447477490353
1973,MI,F,56246,2635,58881,4.475127800139264
1973,MI,M,43921,21859,65780,33.230465186986926
1973,MN,F,21599,1175,22774,5.159392289452884
1973,MN,M,16157,9451,25608,36.906435488909715
1973,MO,F,27773,1386,29159,4.7532494255632916
1973,MO,M,22356,10647,33003,32.26070357240251
1973,MS,F,15502,904,16406,5.510179202730709
1973,MS,M,13980,4996,18976,26.327993254637438
1973,MT,F,3590,178,3768,4.723991507430998
1973,MT,M,3080,1604,4684,34.24423569598633
1973,NC,F,33072,1803,34875,5.16989247311828
1973,NC,M,28266,11158,39424,28.302556818181817
1973,ND,F,3650,159,3809,4.174323969545812
1973,ND,M,3043,1409,4452,31.64869721473495
1973,NE,F,8679,351,9030,3.887043189368771
1973,NE,M,6933,3480,10413,33.41976375684241
1973,NH,F,3967,222,4189,5.299594175220816
1973,NH,M,2943,1945,4888,39.791325695581016
1973,NJ,F,36341,1822,38163,4.774257788957891
1973,NJ,M,28317,14892,43209,34.46504200513782
1973,NM,F,6986,463,7449,6.215599409316687
1973,NM,M,5981,2831,8812,32.12664548343168
1973,NV,F,2404,106,2510,4.223107569721115
1973,NV,M,2086,1237,3323,37.22539873608186
1973,NY,F,97872,5377,103249,5.207798622746951
1973,NY,M,75029,39360,114389,34.40890295395536
1973,OH,F,66874,3377,70251,4.807049009978505
1973,OH,M,50638,26469,77107,34.32762265423372
1973,OK,F,14762,617,15379,4.011964366993953
1973,OK,M,12954,5223,18177,28.734114540353197
1973,OR,F,11643,679,12322,5.510469079694855
1973,OR,M,9164,5183,14347,36.12601937687322
1973,PA,F,64550,3013,67563,4.459541465003034
1973,PA,M,47307,26842,74149,36.200083615423004
1973,RI,F,4459,218,4677,4.661107547573231
1973,RI,M,3322,2272,5594,40.614944583482306
1973,SC,F,17416,964,18380,5.244831338411317
1973,SC,M,15314,6021,21335,28.221232716194045
1973,SD,F,3623,124,3747,3.3093141179610353
1973,SD,M,2985,1416,4401,32.1745057941377
1973,TN,F,25954,1485,27439,5.412004810670943
1973,TN,M,21879,9460,31339,30.186030186030187
1973,TX,F,88891,5519,94410,5.8457790488295736
1973,TX,M,75206,29653,104859,28.278926939986075
1973,UT,F,10341,499,10840,4.6033210332103325
1973,UT,M,8436,4313,12749,33.8301043219076
1973,VA,F,26606,1490,28096,5.303246013667426
1973,VA,M,21691,9962,31653,31.472530249897325
1973,VT,F,2132,127,2259,5.621956617972555
1973,VT,M,1610,1064,2674,39.79057591623037
1973,WA,F,17760,1039,18799,5.52688972817703
1973,WA,M,13778,7704,21482,35.862582627315895
1973,WI,F,25652,1230,26882,4.575552414254892
1973,WI,M,18712,10724,29436,36.43158037776872
1973,WV,F,10761,621,11382,5.455983131259884
1973,WV,M,8658,4394,13052,33.66533864541832
1973,WY,F,1611,59,1670,3.5329341317365266
1973,WY,M,1415,847,2262,37.4447391688771
1974,AK,F,1764,141,1905,7.4015748031496065
1974,AK,M,1502,1177,2679,43.93430384471818
1974,AL,F,21330,1206,22536,5.3514376996805115
1974,AL,M,18561,7866,26427,29.765013054830288
1974,AR,F,12148,669,12817,5.219630178668956
1974,AR,M,10953,4591,15544,29.53551209469892
1974,AZ,F,14454,914,15368,5.947423217074441
1974,AZ,M,11940,6121,18061,33.89070372626101
1974,CA,F,128809,7803,136612,5.711796913887506
1974,CA,M,100759,49694,150453,33.02958398968448
1974,CO,F,14839,836,15675,5.333333333333334
1974,CO,M,11516,6727,18243,36.87441758482706
1974,CT,F,13431,785,14216,5.521947101857062
1974,CT,M,9915,6683,16598,40.26388721532715
1974,DC,F,5545,308,5853,5.262258670767128
1974,DC,M,5216,2736,7952,34.40643863179074
1974,DE,F,2602,134,2736,4.89766081871345
1974,DE,M,2077,1308,3385,38.6410635155096
1974,FL,F,41573,2132,43705,4.878160393547649
1974,FL,M,34532,16192,50724,31.92177273085719
1974,GA,F,31365,1638,33003,4.963185164985001
1974,GA,M,26812,11352,38164,29.745309715962687
1974,HI,F,4247,235,4482,5.243195002231147
1974,HI,M,4025,1929,5954,32.39838763856231
1974,IA,F,16036,800,16836,4.751722499406035
1974,IA,M,12419,6657,19076,34.89725309289159
1974,ID,F,4898,325,5223,6.222477503350564
1974,ID,M,4157,2287,6444,35.49037864680323
1974,IL,F,66143,3559,69702,5.106022782703509
1974,IL,M,51858,26472,78330,33.79548065875144
1974,IN,F,33182,1720,34902,4.928084350467022
1974,IN,M,25602,13954,39556,35.276569926180606
1974,KS,F,11452,588,12040,4.883720930232558
1974,KS,M,9348,4756,14104,33.72093023255814
1974,KY,F,21471,1295,22766,5.6883071246595796
1974,KY,M,17368,8505,25873,32.87210605650678
1974,LA,F,23779,1048,24827,4.221210778587828
1974,LA,M,21887,7594,29481,25.75896340015603
1974,MA,F,28879,1712,30591,5.596417246902684
1974,MA,M,19757,14400,34157,42.15826916883801
1974,MD,F,17571,964,18535,5.200971135689237
1974,MD,M,13564,7270,20834,34.89488336373236
1974,ME,F,5419,380,5799,6.552853940334541
1974,ME,M,3864,2651,6515,40.690713737528775
1974,MI,F,54286,2731,57017,4.789799533472474
1974,MI,M,41722,22461,64183,34.995247962856205
1974,MN,F,22447,1355,23802,5.69279892446013
1974,MN,M,16419,10061,26480,37.994712990936556
1974,MO,F,28148,1526,29674,5.142549032823347
1974,MO,M,22329,11432,33761,33.861556233523885
1974,MS,F,15188,887,16075,5.517884914463453
1974,MS,M,13480,5189,18669,27.79473994322138
1974,MT,F,3878,179,4057,4.412127187577028
1974,MT,M,3280,1817,5097,35.64842063959192
1974,NC,F,32091,1766,33857,5.216055763948371
1974,NC,M,27234,11609,38843,29.886980923203666
1974,ND,F,3720,168,3888,4.320987654320987
1974,ND,M,3016,1538,4554,33.77250768555116
1974,NE,F,9033,392,9425,4.159151193633952
1974,NE,M,7123,3836,10959,35.00319372205493
1974,NH,F,4019,301,4320,6.9675925925925934
1974,NH,M,2902,2204,5106,43.16490403446925
1974,NJ,F,35745,1846,37591,4.910749913543135
1974,NJ,M,27687,15154,42841,35.372657034149526
1974,NM,F,7257,502,7759,6.469905915710787
1974,NM,M,6052,3049,9101,33.50181298758378
1974,NV,F,2405,116,2521,4.601348671162238
1974,NV,M,2050,1329,3379,39.33116306599585
1974,NY,F,97462,5611,103073,5.443714648841112
1974,NY,M,73778,40576,114354,35.48279902758102
1974,OH,F,66630,3489,70119,4.975826808710906
1974,OH,M,50064,27886,77950,35.774214239897375
1974,OK,F,15107,742,15849,4.681683386964478
1974,OK,M,12968,5655,18623,30.365676851205496
1974,OR,F,12241,804,13045,6.163280950555769
1974,OR,M,9481,5515,14996,36.77647372632702
1974,PA,F,63739,3113,66852,4.656554777717944
1974,PA,M,45722,27697,73419,37.72456721012272
1974,RI,F,4232,230,4462,5.154639175257731
1974,RI,M,2841,2227,5068,43.94238358326756
1974,SC,F,16652,907,17559,5.165442223361239
1974,SC,M,14799,6030,20829,28.950021604493735
1974,SD,F,3770,173,3943,4.387522191224956
1974,SD,M,3059,1564,4623,33.83084577114428
1974,TN,F,26003,1495,27498,5.436759037020874
1974,TN,M,21314,9924,31238,31.76899929572956
1974,TX,F,89768,5700,95468,5.970587002974819
1974,TX,M,74884,30903,105787,29.21247412252923
1974,UT,F,11189,519,11708,4.4328664161257265
1974,UT,M,8858,4821,13679,35.243804371664595
1974,VA,F,26204,1574,27778,5.666354669162646
1974,VA,M,20894,10530,31424,33.509419551934826
1974,VT,F,2047,158,2205,7.165532879818594
1974,VT,M,1520,1132,2652,42.68476621417798
1974,WA,F,18531,1115,19646,5.675455563473481
1974,WA,M,14472,8430,22902,36.80901231333508
1974,WI,F,26064,1407,27471,5.121764770121219
1974,WI,M,19147,11623,30770,37.77380565485863
1974,WV,F,10564,602,11166,5.39136664875515
1974,WV,M,8285,4543,12828,35.414717804801995
1974,WY,F,1715,85,1800,4.722222222222222
1974,WY,M,1489,939,2428,38.67380560131796
1975,AK,F,1991,169,2160,7.8240740740740735
1975,AK,M,1677,1133,2810,40.320284697508896
1975,AL,F,20741,1110,21851,5.079859045352615
1975,AL,M,17844,7669,25513,30.059185513267746
1975,AR,F,11951,682,12633,5.398559328742183
1975,AR,M,10369,4526,14895,30.386035582410205
1975,AZ,F,14287,888,15175,5.85172981878089
1975,AZ,M,11524,6011,17535,34.28001140575991
1975,CA,F,130815,7607,138422,5.495513718917513
1975,CA,M,101798,50418,152216,33.12266778788038
1975,CO,F,14901,899,15800,5.689873417721519
1975,CO,M,11692,7034,18726,37.562746982804654
1975,CT,F,13005,826,13831,5.9720916781143805
1975,CT,M,9822,6489,16311,39.78296854883207
1975,DC,F,5550,341,5891,5.788490918350026
1975,DC,M,5164,2512,7676,32.72537780093799
1975,DE,F,2571,147,2718,5.408388520971302
1975,DE,M,1960,1352,3312,40.82125603864734
1975,FL,F,39413,1949,41362,4.712054542817079
1975,FL,M,32600,15489,48089,32.20902909189212
1975,GA,F,29501,1491,30992,4.810918946824987
1975,GA,M,25537,10947,36484,30.00493366955378
1975,HI,F,4322,199,4521,4.401681044016811
1975,HI,M,4135,1920,6055,31.709331131296448
1975,IA,F,16453,846,17299,4.8904560957280765
1975,IA,M,12481,7156,19637,36.441411620919695
1975,ID,F,5163,320,5483,5.836221046872151
1975,ID,M,4274,2516,6790,37.05449189985273
1975,IL,F,65945,3697,69642,5.308578156859366
1975,IL,M,51451,26847,78298,34.288232138751944
1975,IN,F,32589,1790,34379,5.206666860583495
1975,IN,M,25206,14025,39231,35.749789707119376
1975,KS,F,11936,631,12567,5.021086973820323
1975,KS,M,9771,4946,14717,33.607392811034856
1975,KY,F,22036,1361,23397,5.8169850835577215
1975,KY,M,17290,8722,26012,33.53067814854682
1975,LA,F,24478,1084,25562,4.240669744151475
1975,LA,M,22243,7951,30194,26.33304630058952
1975,MA,F,27655,1717,29372,5.845703390984611
1975,MA,M,18834,14262,33096,43.09282088469906
1975,MD,F,16841,844,17685,4.77240599378004
1975,MD,M,13461,7281,20742,35.10269019380966
1975,ME,F,5401,330,5731,5.758157389635317
1975,ME,M,3763,2815,6578,42.79416235937975
1975,MI,F,52846,2851,55697,5.118767617645474
1975,MI,M,39856,22058,61914,35.62683722582938
1975,MN,F,22757,1396,24153,5.779820312176541
1975,MN,M,16439,10457,26896,38.87938726948245
1975,MO,F,27486,1642,29128,5.63718758582807
1975,MO,M,21343,11564,32907,35.141459263986384
1975,MS,F,14709,847,15556,5.4448444330162
1975,MS,M,13171,5095,18266,27.89335377203548
1975,MT,F,3649,186,3835,4.85006518904824
1975,MT,M,3207,1794,5001,35.87282543491302
1975,NC,F,30816,1540,32356,4.759550006181234
1975,NC,M,25301,11280,36581,30.835679724447118
1975,ND,F,3934,181,4115,4.39854191980559
1975,ND,M,3069,1685,4754,35.4438367690366
1975,NE,F,9058,392,9450,4.148148148148148
1975,NE,M,6869,3898,10767,36.20321352280115
1975,NH,F,3975,262,4237,6.183620486193061
1975,NH,M,2779,2145,4924,43.562144597887894
1975,NJ,F,34227,1735,35962,4.824537011289695
1975,NJ,M,26306,14969,41275,36.26650514839491
1975,NM,F,7228,431,7659,5.627366496931714
1975,NM,M,5768,3018,8786,34.350102435693145
1975,NV,F,2491,129,2620,4.923664122137405
1975,NV,M,2039,1347,3386,39.78145304193739
1975,NY,F,96158,5544,101702,5.451220231657194
1975,NY,M,72891,39735,112626,35.28048585584146
1975,OH,F,65832,3494,69326,5.0399561492080895
1975,OH,M,48725,27890,76615,36.402793186712785
1975,OK,F,15156,791,15947,4.960180598231642
1975,OK,M,12900,5769,18669,30.901494456050138
1975,OR,F,12216,861,13077,6.58407891718284
1975,OR,M,9771,6017,15788,38.111223714213324
1975,PA,F,61964,3097,65061,4.760148168641736
1975,PA,M,44526,27275,71801,37.98693611509589
1975,RI,F,3746,200,3946,5.068423720223011
1975,RI,M,2664,2201,4865,45.2415210688592
1975,SC,F,15712,867,16579,5.229507207913626
1975,SC,M,13902,5924,19826,29.879955613840416
1975,SD,F,3731,192,3923,4.894213612031609
1975,SD,M,3094,1634,4728,34.5600676818951
1975,TN,F,24963,1477,26440,5.586232980332829
1975,TN,M,20222,9897,30119,32.8596566951094
1975,TX,F,90135,5573,95708,5.822919714130481
1975,TX,M,75571,31639,107210,29.511239623169484
1975,UT,F,11731,620,12351,5.019836450489839
1975,UT,M,9248,5219,14467,36.07520564042303
1975,VA,F,25567,1493,27060,5.517368810051737
1975,VA,M,20437,10496,30933,33.93140012284615
1975,VT,F,2051,148,2199,6.730331969076852
1975,VT,M,1528,1169,2697,43.34445680385613
1975,WA,F,18661,1208,19869,6.079822839599376
1975,WA,M,14489,8749,23238,37.64953954729322
1975,WI,F,26029,1436,27465,5.228472601492809
1975,WI,M,18795,12101,30896,39.16688244432937
1975,WV,F,10633,567,11200,5.0625
1975,WV,M,8281,4759,13040,36.49539877300613
1975,WY,F,1812,100,1912,5.230125523012552
1975,WY,M,1513,971,2484,39.090177133655395
1976,AK,F,2042,157,2199,7.139608913142337
1976,AK,M,1719,1276,2995,42.60434056761269
1976,AL,F,20404,1106,21510,5.141794514179451
1976,AL,M,17243,7918,25161,31.469337466714357
1976,AR,F,11780,613,12393,4.9463406761881705
1976,AR,M,10144,4703,14847,31.67643294941739
1976,AZ,F,14341,923,15264,6.046907756813417
1976,AZ,M,11527,6388,17915,35.657270443762215
1976,CA,F,135730,8140,143870,5.657885591158685
1976,CA,M,105791,53044,158835,33.395662165139925
1976,CO,F,15257,961,16218,5.925514860032063
1976,CO,M,11634,7223,18857,38.30407806119743
1976,CT,F,12834,881,13715,6.423623769595334
1976,CT,M,9298,6583,15881,41.45204961904162
1976,DC,F,5479,344,5823,5.9076077623218275
1976,DC,M,5005,2659,7664,34.6946764091858
1976,DE,F,2436,144,2580,5.5813953488372094
1976,DE,M,1868,1407,3275,42.9618320610687
1976,FL,F,38964,2007,40971,4.898586805301311
1976,FL,M,31906,15353,47259,32.48693370574917
1976,GA,F,29367,1514,30881,4.902690975033193
1976,GA,M,24447,11217,35664,31.45188425302826
1976,HI,F,4448,186,4634,4.013810962451446
1976,HI,M,4223,1981,6204,31.931012250161185
1976,IA,F,16632,930,17562,5.295524427741715
1976,IA,M,12302,7297,19599,37.23149140262259
1976,ID,F,5504,335,5839,5.737283781469429
1976,ID,M,4575,2644,7219,36.625571408782385
1976,IL,F,66168,3757,69925,5.372899535216303
1976,IL,M,51208,27270,78478,34.74859196207854
1976,IN,F,31896,1888,33784,5.588444233956903
1976,IN,M,24040,14128,38168,37.01530077551876
1976,KS,F,12326,687,13013,5.279336048566818
1976,KS,M,9859,5341,15200,35.13815789473684
1976,KY,F,22180,1265,23445,5.395606739176797
1976,KY,M,17540,9110,26650,34.18386491557223
1976,LA,F,24942,1094,26036,4.201874327853742
1976,LA,M,22343,8069,30412,26.532289885571487
1976,MA,F,26868,1708,28576,5.977043673012318
1976,MA,M,18350,13722,32072,42.78498378648042
1976,MD,F,16568,886,17454,5.076200297925977
1976,MD,M,12956,7305,20261,36.05448891959923
1976,ME,F,5279,359,5638,6.367506207875133
1976,ME,M,3797,2718,6515,41.7191097467383
1976,MI,F,51537,2894,54431,5.316823133875916
1976,MI,M,38795,22371,61166,36.5742405911781
1976,MN,F,22467,1590,24057,6.609302905599201
1976,MN,M,16122,10919,27041,40.37942383787582
1976,MO,F,27847,1654,29501,5.606589607131961
1976,MO,M,21165,11871,33036,35.93352706138758
1976,MS,F,14424,766,15190,5.042791310072416
1976,MS,M,12906,5162,18068,28.569847243745848
1976,MT,F,3954,220,4174,5.270723526593196
1976,MT,M,3214,1893,5107,37.06677109849227
1976,NC,F,30333,1651,31984,5.1619559779889945
1976,NC,M,24799,11467,36266,31.619147410797993
1976,ND,F,3896,226,4122,5.482775351770985
1976,ND,M,3120,1834,4954,37.02058942268874
1976,NE,F,9003,455,9458,4.810742228801015
1976,NE,M,6756,4025,10781,37.334199053891105
1976,NH,F,3998,293,4291,6.828245164297367
1976,NH,M,2679,2143,4822,44.4421401907922
1976,NJ,F,33610,1598,35208,4.538741195182913
1976,NJ,M,25753,14764,40517,36.43902559419503
1976,NM,F,7222,449,7671,5.853213401121105
1976,NM,M,6232,3190,9422,33.856930587985566
1976,NV,F,2731,119,2850,4.175438596491228
1976,NV,M,2186,1501,3687,40.71060482777325
1976,NY,F,94668,5559,100227,5.5464096500942865
1976,NY,M,72230,40071,112301,35.68178377752647
1976,OH,F,63817,3530,67347,5.241510386505709
1976,OH,M,46958,27983,74941,37.34004083212127
1976,OK,F,15260,782,16042,4.874703902256576
1976,OK,M,13043,6081,19124,31.797741058355992
1976,OR,F,12835,962,13797,6.972530260201493
1976,OR,M,9734,6498,16232,40.032035485460824
1976,PA,F,61419,3000,64419,4.657011130256601
1976,PA,M,43709,27885,71594,38.948794591725566
1976,RI,F,3849,225,4074,5.522827687776141
1976,RI,M,2683,2226,4909,45.34528417192911
1976,SC,F,16016,895,16911,5.2924132221630895
1976,SC,M,13832,6116,19948,30.659715259675156
1976,SD,F,3931,196,4127,4.749212503028835
1976,SD,M,3120,1735,4855,35.736354273944386
1976,TN,F,24605,1571,26176,6.001680929095354
1976,TN,M,19781,10005,29786,33.58960585509971
1976,TX,F,91049,5645,96694,5.8380044263346225
1976,TX,M,75028,32641,107669,30.316061261830242
1976,UT,F,13076,745,13821,5.39034802112727
1976,UT,M,10315,6108,16423,37.1917432868538
1976,VA,F,25406,1509,26915,5.60653910458852
1976,VA,M,19876,10732,30608,35.06272869837951
1976,VT,F,1927,165,2092,7.88718929254302
1976,VT,M,1428,1275,2703,47.16981132075472
1976,WA,F,19505,1350,20855,6.473267801486454
1976,WA,M,14960,9249,24209,38.204799867817755
1976,WI,F,25857,1576,27433,5.744905770422483
1976,WI,M,18385,12365,30750,40.21138211382114
1976,WV,F,10970,617,11587,5.324933114697506
1976,WV,M,8290,4930,13220,37.29198184568835
1976,WY,F,1985,104,2089,4.978458592628051
1976,WY,M,1657,1007,2664,37.8003003003003
1977,AK,F,2252,169,2421,6.98058653448988
1977,AK,M,1780,1361,3141,43.33014963387456
1977,AL,F,21789,1213,23002,5.273454482218938
1977,AL,M,18472,8356,26828,31.146563292082895
1977,AR,F,12266,730,12996,5.6171129578331795
1977,AR,M,10476,4973,15449,32.189785746650266
1977,AZ,F,14972,980,15952,6.143430290872618
1977,AZ,M,11958,6691,18649,35.87859938870717
1977,CA,F,140744,8800,149544,5.8845557160434385
1977,CA,M,110051,55543,165594,33.541674215249344
1977,CO,F,16068,1004,17072,5.8809746954076845
1977,CO,M,12010,7673,19683,38.98287862622568
1977,CT,F,13348,897,14245,6.296946296946297
1977,CT,M,9371,6631,16002,41.43857017872766
1977,DC,F,5688,356,6044,5.890138980807412
1977,DC,M,5083,2839,7922,35.836909871244636
1977,DE,F,2679,102,2781,3.6677454153182305
1977,DE,M,1930,1468,3398,43.20188346085933
1977,FL,F,41015,2197,43212,5.084235860409145
1977,FL,M,33234,16863,50097,33.660698245403914
1977,GA,F,31236,1610,32846,4.901662302867929
1977,GA,M,25946,11979,37925,31.58602504943968
1977,HI,F,4437,222,4659,4.764971023824855
1977,HI,M,4300,2048,6348,32.262129804662884
1977,IA,F,17791,1142,18933,6.031796334442508
1977,IA,M,12827,8285,21112,39.24308450170519
1977,ID,F,5883,389,6272,6.202168367346939
1977,ID,M,4969,2958,7927,37.31550397376056
1977,IL,F,68252,4062,72314,5.617169566059131
1977,IL,M,52583,28816,81399,35.400926301305915
1977,IN,F,33136,2093,35229,5.94112804791507
1977,IN,M,25173,15326,40499,37.842909701474106
1977,KS,F,12796,721,13517,5.334023821853961
1977,KS,M,10042,5577,15619,35.706511300339336
1977,KY,F,23138,1442,24580,5.866558177379984
1977,KY,M,18242,9950,28192,35.293700340522136
1977,LA,F,26723,1260,27983,4.5027338026659045
1977,LA,M,24090,8948,33038,27.08396392033416
1977,MA,F,27596,1817,29413,6.177540543297182
1977,MA,M,18568,14478,33046,43.81165647884767
1977,MD,F,17519,949,18468,5.138618150314056
1977,MD,M,13980,7713,21693,35.5552482367584
1977,ME,F,5498,406,5904,6.876693766937669
1977,ME,M,3966,3056,7022,43.520364568499005
1977,MI,F,53843,3263,57106,5.713935488390011
1977,MI,M,40308,24053,64361,37.372011000450584
1977,MN,F,24169,1716,25885,6.629322001158973
1977,MN,M,16812,11983,28795,41.61486369161313
1977,MO,F,29079,1908,30987,6.157420853906477
1977,MO,M,22309,12867,35176,36.578917443711624
1977,MS,F,14930,879,15809,5.560123980011386
1977,MS,M,13796,5386,19182,28.078406839745597
1977,MT,F,4083,246,4329,5.682605682605683
1977,MT,M,3474,2058,5532,37.20173535791757
1977,NC,F,31326,1743,33069,5.270797423568902
1977,NC,M,25986,12533,38519,32.53718943897817
1977,ND,F,4197,262,4459,5.8757568961650595
1977,ND,M,3461,1885,5346,35.2600074822297
1977,NE,F,9557,499,10056,4.962211614956245
1977,NE,M,7045,4382,11427,38.34777281876258
1977,NH,F,4230,309,4539,6.8076668869795105
1977,NH,M,3007,2492,5499,45.3173304237134
1977,NJ,F,34877,1824,36701,4.96989182856053
1977,NJ,M,26274,15398,41672,36.9504703397965
1977,NM,F,7594,469,8063,5.816693538385216
1977,NM,M,6133,3347,9480,35.30590717299578
1977,NV,F,2887,164,3051,5.375286791215995
1977,NV,M,2252,1570,3822,41.07796964939822
1977,NY,F,96211,5570,101781,5.472534166494729
1977,NY,M,72553,41091,113644,36.15765020590616
1977,OH,F,66218,3899,70117,5.560705677653066
1977,OH,M,48080,29452,77532,37.98689573337461
1977,OK,F,15956,958,16914,5.663947026132198
1977,OK,M,13267,6601,19868,33.22428024964768
1977,OR,F,13709,1024,14733,6.9503834928392045
1977,OR,M,10550,6981,17531,39.820888711425475
1977,PA,F,63173,3227,66400,4.859939759036144
1977,PA,M,44647,29596,74243,39.86369085300971
1977,RI,F,4153,266,4419,6.019461416610093
1977,RI,M,2858,2412,5270,45.76850094876661
1977,SC,F,16608,950,17558,5.410639024945894
1977,SC,M,14406,6289,20695,30.388982846098088
1977,SD,F,4078,218,4296,5.074487895716946
1977,SD,M,3130,1917,5047,37.98296017436101
1977,TN,F,26379,1659,28038,5.916969826663814
1977,TN,M,20804,11128,31932,34.84905424026055
1977,TX,F,94633,5835,100468,5.80781940518374
1977,TX,M,77600,34671,112271,30.881527732005594
1977,UT,F,13867,830,14697,5.647411036265904
1977,UT,M,10990,6568,17558,37.40744959562593
1977,VA,F,26560,1633,28193,5.79221792643564
1977,VA,M,21100,11531,32631,35.33756244062395
1977,VT,F,2109,223,2332,9.562607204116638
1977,VT,M,1493,1262,2755,45.80762250453721
1977,WA,F,21216,1556,22772,6.832952748989987
1977,WA,M,15888,10009,25897,38.6492643935591
1977,WI,F,27215,1769,28984,6.103367375103506
1977,WI,M,18950,13214,32164,41.083198607138414
1977,WV,F,11586,746,12332,6.049302627311061
1977,WV,M,8845,5426,14271,38.021161796650546
1977,WY,F,2258,116,2374,4.886267902274642
1977,WY,M,1817,1229,3046,40.34799737360473
1978,AK,F,2279,214,2493,8.584035298836742
1978,AK,M,1877,1470,3347,43.91992829399462
1978,AL,F,20570,1180,21750,5.425287356321839
1978,AL,M,17469,8342,25811,32.319553678664136
1978,AR,F,11837,746,12583,5.928633871095923
1978,AR,M,9747,4999,14746,33.90071883900719
1978,AZ,F,15312,1073,16385,6.548672566371681
1978,AZ,M,12201,6867,19068,36.013215859030836
1978,CA,F,143809,9513,153322,6.204589034841706
1978,CA,M,111738,57270,169008,33.885969894916215
1978,CO,F,16171,1137,17308,6.569216547261382
1978,CO,M,12319,7881,20200,39.01485148514852
1978,CT,F,13223,967,14190,6.814658210007048
1978,CT,M,9687,6776,16463,41.158962522019074
1978,DC,F,5163,366,5529,6.619641888225719
1978,DC,M,5016,2647,7663,34.54260733394232
1978,DE,F,2630,148,2778,5.327573794096472
1978,DE,M,2086,1478,3564,41.470258136924805
1978,FL,F,41752,2272,44024,5.16082137016173
1978,FL,M,33894,17176,51070,33.63226943411004
1978,GA,F,30525,1708,32233,5.298917258710017
1978,GA,M,25564,12262,37826,32.41685613070375
1978,HI,F,4359,198,4557,4.3449637919684
1978,HI,M,4273,2085,6358,32.79333123623781
1978,IA,F,17414,1177,18591,6.3310203862083805
1978,IA,M,12668,8429,21097,39.95354789780537
1978,ID,F,6244,441,6685,6.596858638743456
1978,ID,M,4888,3098,7986,38.79288755321813
1978,IL,F,66819,4085,70904,5.761311068486968
1978,IL,M,51317,28122,79439,35.400747743551655
1978,IN,F,32489,2310,34799,6.638121785108768
1978,IN,M,24316,15015,39331,38.1759934911393
1978,KS,F,12607,831,13438,6.1839559458252715
1978,KS,M,9873,5744,15617,36.780431580969456
1978,KY,F,22379,1501,23880,6.285594639865996
1978,KY,M,17410,9890,27300,36.227106227106226
1978,LA,F,26161,1345,27506,4.889842216243729
1978,LA,M,23899,9150,33049,27.686162970135253
1978,MA,F,27737,1918,29655,6.46771202158152
1978,MA,M,18402,14784,33186,44.54890616525041
1978,MD,F,17297,979,18276,5.356752024513022
1978,MD,M,13547,7832,21379,36.63408017213153
1978,ME,F,5462,453,5915,7.658495350803044
1978,ME,M,3777,3022,6799,44.44771289895573
1978,MI,F,54152,3397,57549,5.902795878295018
1978,MI,M,39828,24430,64258,38.01861246848641
1978,MN,F,24652,1887,26539,7.110290515844605
1978,MN,M,16921,12579,29500,42.64067796610169
1978,MO,F,28676,1969,30645,6.425191711535323
1978,MO,M,21949,13029,34978,37.24912802332895
1978,MS,F,14499,841,15340,5.482398956975229
1978,MS,M,13040,5420,18460,29.360780065005414
1978,MT,F,4087,303,4390,6.902050113895217
1978,MT,M,3357,2137,5494,38.89697852202403
1978,NC,F,30621,1751,32372,5.408995428147782
1978,NC,M,24758,12437,37195,33.43728995832773
1978,ND,F,4075,270,4345,6.214039125431531
1978,ND,M,3298,1963,5261,37.3122980421973
1978,NE,F,9243,579,9822,5.894929749541845
1978,NE,M,7105,4522,11627,38.89223359422035
1978,NH,F,4324,371,4695,7.9020234291799785
1978,NH,M,3001,2484,5485,45.287146763901546
1978,NJ,F,34506,1741,36247,4.8031561232653734
1978,NJ,M,25975,15397,41372,37.21599149183022
1978,NM,F,7617,576,8193,7.030391797876236
1978,NM,M,6520,3591,10111,35.51577489862526
1978,NV,F,3122,196,3318,5.9071729957805905
1978,NV,M,2449,1692,4141,40.85969572567013
1978,NY,F,92760,5508,98268,5.605079985346196
1978,NY,M,69614,40692,110306,36.89010570594528
1978,OH,F,64741,4209,68950,6.104423495286439
1978,OH,M,47391,29689,77080,38.51712506486767
1978,OK,F,16033,968,17001,5.693782718663607
1978,OK,M,13259,6632,19891,33.34171233221055
1978,OR,F,14243,1212,15455,7.842122290520867
1978,OR,M,10883,7274,18157,40.06168419893154
1978,PA,F,62485,3510,65995,5.318584741268277
1978,PA,M,44039,29391,73430,40.02587498297699
1978,RI,F,4054,250,4304,5.808550185873606
1978,RI,M,2672,2460,5132,47.93452844894778
1978,SC,F,16030,1023,17053,5.9989444672491645
1978,SC,M,13842,6659,20501,32.48134237354275
1978,SD,F,4030,217,4247,5.109489051094891
1978,SD,M,3326,1913,5239,36.51460202328688
1978,TN,F,26023,1840,27863,6.60373972651904
1978,TN,M,20543,11405,31948,35.69863528233379
1978,TX,F,97236,6174,103410,5.970409051348999
1978,TX,M,78991,36237,115228,31.44808553476586
1978,UT,F,14298,876,15174,5.773032819296164
1978,UT,M,11006,6889,17895,38.49678681195865
1978,VA,F,26053,1807,27860,6.48600143575018
1978,VA,M,20499,11600,32099,36.13819745163401
1978,VT,F,2222,238,2460,9.674796747967479
1978,VT,M,1502,1316,2818,46.69978708303761
1978,WA,F,21333,1617,22950,7.045751633986928
1978,WA,M,16363,10450,26813,38.97363219333905
1978,WI,F,27156,1810,28966,6.248705378719879
1978,WI,M,18803,13358,32161,41.534778147445664
1978,WV,F,11022,775,11797,6.569466813596677
1978,WV,M,8289,5391,13680,39.4078947368421
1978,WY,F,2300,140,2440,5.737704918032787
1978,WY,M,1901,1335,3236,41.25463535228677
1979,AK,F,2454,223,2677,8.330220395965632
1979,AK,M,2053,1501,3554,42.234102419808664
1979,AL,F,21723,1185,22908,5.172865374541645
1979,AL,M,18139,8885,27024,32.87818235642392
1979,AR,F,12192,775,12967,5.976710110279941
1979,AR,M,10487,5464,15951,34.25490564854868
1979,AZ,F,16736,1130,17866,6.324862868017464
1979,AZ,M,13185,7815,21000,37.214285714285715
1979,CA,F,153373,9922,163295,6.076119905692153
1979,CA,M,119710,60150,179860,33.44267763816301
1979,CO,F,17416,1244,18660,6.666666666666667
1979,CO,M,13052,8771,21823,40.19154103468817
1979,CT,F,13742,965,14707,6.561501325899231
1979,CT,M,10187,7123,17310,41.14962449451184
1979,DC,F,5172,384,5556,6.911447084233262
1979,DC,M,5148,2759,7907,34.89313266725686
1979,DE,F,2628,133,2761,4.8170952553422675
1979,DE,M,2142,1571,3713,42.3107998922704
1979,FL,F,44425,2431,46856,5.188236298446303
1979,FL,M,36174,18646,54820,34.01313389273988
1979,GA,F,31819,1818,33637,5.404762612599221
1979,GA,M,26348,12992,39340,33.02491103202847
1979,HI,F,4526,234,4760,4.915966386554622
1979,HI,M,4223,2228,6451,34.53728104169896
1979,IA,F,18539,1160,19699,5.888623788009544
1979,IA,M,13125,9052,22177,40.81706272264057
1979,ID,F,6460,446,6906,6.458152331306111
1979,ID,M,5143,3290,8433,39.013399739120125
1979,IL,F,70364,4304,74668,5.764182782450313
1979,IL,M,53899,29918,83817,35.694429531002065
1979,IN,F,33858,2372,36230,6.547060447143252
1979,IN,M,25303,15809,41112,38.453492897450865
1979,KS,F,13496,878,14374,6.108251008765827
1979,KS,M,10531,6324,16855,37.520023731830314
1979,KY,F,22946,1538,24484,6.28165332462016
1979,KY,M,17697,10480,28177,37.19345565532171
1979,LA,F,27845,1424,29269,4.865215757285866
1979,LA,M,25133,9789,34922,28.031040604776358
1979,MA,F,28609,2036,30645,6.643824441181269
1979,MA,M,18841,15079,33920,44.45459905660377
1979,MD,F,18343,1133,19476,5.817416307249949
1979,MD,M,14311,8376,22687,36.919821924450126
1979,ME,F,5635,464,6099,7.607804558124283
1979,ME,M,3947,3217,7164,44.90508096035734
1979,MI,F,55945,3630,59575,6.093159882501049
1979,MI,M,41546,25572,67118,38.100062576358056
1979,MN,F,25847,1932,27779,6.9548939846646745
1979,MN,M,17591,13555,31146,43.52083734668978
1979,MO,F,30216,2064,32280,6.394052044609666
1979,MO,M,22811,13962,36773,37.968074402414814
1979,MS,F,14707,879,15586,5.639676632875658
1979,MS,M,13305,5628,18933,29.725875455553798
1979,MT,F,4344,337,4681,7.199316385387737
1979,MT,M,3515,2302,5817,39.5736634003782
1979,NC,F,31001,1862,32863,5.665946505188205
1979,NC,M,24841,12746,37587,33.91066060073962
1979,ND,F,4348,275,4623,5.948518278174346
1979,ND,M,3324,2203,5527,39.858874615523796
1979,NE,F,9726,577,10303,5.600310589148791
1979,NE,M,7322,4650,11972,38.840628132308716
1979,NH,F,4454,367,4821,7.612528521053723
1979,NH,M,3059,2642,5701,46.34274688651114
1979,NJ,F,35354,1830,37184,4.921471600688468
1979,NJ,M,26461,15990,42451,37.666957197710296
1979,NM,F,8118,561,8679,6.4638783269961975
1979,NM,M,6587,3695,10282,35.93658821241004
1979,NV,F,3516,208,3724,5.5853920515574655
1979,NV,M,2948,2042,4990,40.921843687374746
1979,NY,F,93071,5791,98862,5.857660172766078
1979,NY,M,69613,41417,111030,37.30253084751869
1979,OH,F,67609,4477,72086,6.2106372943428685
1979,OH,M,49198,31248,80446,38.843447778634115
1979,OK,F,17404,1117,18521,6.03099184709249
1979,OK,M,13924,7431,21355,34.797471318192464
1979,OR,F,15570,1224,16794,7.288317256162916
1979,OR,M,11490,7931,19421,40.83723804129551
1979,PA,F,64726,3688,68414,5.39070950390271
1979,PA,M,45561,30555,76116,40.14267696673499
1979,RI,F,4173,300,4473,6.70690811535882
1979,RI,M,2851,2451,5302,46.22783855149
1979,SC,F,16264,977,17241,5.666724667942695
1979,SC,M,14382,6708,21090,31.806543385490755
1979,SD,F,4467,234,4701,4.977664326738992
1979,SD,M,3206,2112,5318,39.7141782625047
1979,TN,F,26602,1881,28483,6.6039391917986165
1979,TN,M,21208,11671,32879,35.49682167949147
1979,TX,F,104344,6748,111092,6.074244770100457
1979,TX,M,83827,39624,123451,32.09694534673676
1979,UT,F,15171,907,16078,5.641248911556164
1979,UT,M,11963,7066,19029,37.132797309369906
1979,VA,F,27332,1864,29196,6.384436224140293
1979,VA,M,21244,12094,33338,36.27692123102765
1979,VT,F,2236,231,2467,9.363599513579246
1979,VT,M,1649,1423,3072,46.32161458333333
1979,WA,F,23482,1838,25320,7.259083728278042
1979,WA,M,18210,11474,29684,38.65382023985986
1979,WI,F,28557,2037,30594,6.658168268287899
1979,WI,M,19974,14575,34549,42.18645981070364
1979,WV,F,11362,818,12180,6.7159277504105095
1979,WV,M,8287,5620,13907,40.41130366002733
1979,WY,F,2715,146,2861,5.103110800419434
1979,WY,M,2081,1492,3573,41.75762664427652
1980,AK,F,2589,251,2840,8.838028169014084
1980,AK,M,2092,1587,3679,43.13672193530851
1980,AL,F,21581,1422,23003,6.181802373603443
1980,AL,M,18113,9330,27443,33.99774077178151
1980,AR,F,12590,914,13504,6.768364928909952
1980,AR,M,10488,5734,16222,35.34705954876094
1980,AZ,F,17979,1311,19290,6.796267496111976
1980,AZ,M,14295,8284,22579,36.68895876699588
1980,CA,F,162675,10954,173629,6.308853935690466
1980,CA,M,128060,64350,192410,33.44420768151343
1980,CO,F,18297,1403,19700,7.121827411167512
1980,CO,M,13756,9107,22863,39.83291781480995
1980,CT,F,13802,1092,14894,7.331811467705116
1980,CT,M,10045,7340,17385,42.22030486051194
1980,DC,F,5208,408,5616,7.264957264957266
1980,DC,M,5113,2770,7883,35.13890650767475
1980,DE,F,2861,191,3052,6.258191349934469
1980,DE,M,2170,1620,3790,42.74406332453825
1980,FL,F,48666,2928,51594,5.67507849749971
1980,FL,M,39211,20593,59804,34.434151561768445
1980,GA,F,33131,2152,35283,6.099254598531871
1980,GA,M,27504,13729,41233,33.29614629059249
1980,HI,F,4756,283,5039,5.616193689224053
1980,HI,M,4586,2340,6926,33.78573491192608
1980,IA,F,18666,1414,20080,7.041832669322709
1980,IA,M,13442,9155,22597,40.514227552329956
1980,ID,F,6387,511,6898,7.407944331690346
1980,ID,M,5189,3371,8560,39.38084112149532
1980,IL,F,72361,4907,77268,6.35062380286794
1980,IL,M,55245,31186,86431,36.081961333317906
1980,IN,F,34340,2636,36976,7.128948507139767
1980,IN,M,25264,16510,41774,39.52219083640542
1980,KS,F,14025,1090,15115,7.2113794244128355
1980,KS,M,11082,6858,17940,38.22742474916388
1980,KY,F,23036,1822,24858,7.329632311529489
1980,KY,M,17323,10801,28124,38.40492106386005
1980,LA,F,29061,1635,30696,5.32642689601251
1980,LA,M,25976,10600,36576,28.980752405949257
1980,MA,F,29107,2137,31244,6.839713224939188
1980,MA,M,19330,15480,34810,44.469979890835965
1980,MD,F,18932,1250,20182,6.193637895154098
1980,MD,M,14559,8849,23408,37.80331510594668
1980,ME,F,5548,507,6055,8.37324525185797
1980,ME,M,3919,3305,7224,45.75027685492802
1980,MI,F,56058,4212,60270,6.988551518168243
1980,MI,M,41680,25700,67380,38.14188186405462
1980,MN,F,26924,2215,29139,7.601496276467964
1980,MN,M,17982,14522,32504,44.677578144228406
1980,MO,F,30922,2498,33420,7.474566128067026
1980,MO,M,23163,14226,37389,38.048623926823396
1980,MS,F,15399,1024,16423,6.235158010107775
1980,MS,M,13869,6142,20011,30.69311878466843
1980,MT,F,4349,339,4688,7.231228668941979
1980,MT,M,3449,2353,5802,40.55498104102034
1980,NC,F,31123,2122,33245,6.38291472401865
1980,NC,M,25084,13301,38385,34.65155659762929
1980,ND,F,4458,263,4721,5.570853632704935
1980,ND,M,3448,2252,5700,39.50877192982456
1980,NE,F,10075,682,10757,6.340057636887608
1980,NE,M,7635,5097,12732,40.03298774740811
1980,NH,F,4857,436,5293,8.237294539958436
1980,NH,M,3305,2764,6069,45.54292305157357
1980,NJ,F,35220,1971,37191,5.299669274824554
1980,NJ,M,26708,16017,42725,37.48858981860737
1980,NM,F,8693,631,9324,6.767481767481767
1980,NM,M,7262,4054,11316,35.825379992930365
1980,NV,F,3916,274,4190,6.539379474940334
1980,NV,M,3184,2120,5304,39.969834087481146
1980,NY,F,93900,5916,99816,5.926905506131281
1980,NY,M,70676,41864,112540,37.19921805580238
1980,OH,F,68251,5066,73317,6.909720801451233
1980,OH,M,49605,32017,81622,39.22594398569013
1980,OK,F,18006,1294,19300,6.704663212435233
1980,OK,M,15066,7914,22980,34.43864229765013
1980,OR,F,15896,1422,17318,8.211109827924702
1980,OR,M,11832,8065,19897,40.53374880635271
1980,PA,F,65016,3927,68943,5.696009747182456
1980,PA,M,45402,31265,76667,40.780257477141404
1980,RI,F,4196,346,4542,7.6177895200352275
1980,RI,M,2902,2611,5513,47.36078360239434
1980,SC,F,16838,1051,17889,5.8751187880820614
1980,SC,M,14667,6859,21526,31.863792622874666
1980,SD,F,4393,288,4681,6.152531510361034
1980,SD,M,3500,2175,5675,38.32599118942731
1980,TN,F,26382,2038,28420,7.17100633356791
1980,TN,M,21161,12375,33536,36.90064408396946
1980,TX,F,112150,7712,119862,6.43406584238541
1980,TX,M,90588,42873,133461,32.12399127835098
1980,UT,F,15441,1019,16460,6.190765492102066
1980,UT,M,12092,7244,19336,37.46379809681423
1980,VA,F,27793,2032,29825,6.813076278290025
1980,VA,M,21330,12592,33922,37.12045280349036
1980,VT,F,2400,248,2648,9.365558912386707
1980,VT,M,1626,1615,3241,49.83029929034249
1980,WA,F,24683,2145,26828,7.995377963321902
1980,WA,M,18833,12311,31144,39.52928332905215
1980,WI,F,29319,2164,31483,6.873550805196456
1980,WI,M,20299,14999,35298,42.492492492492495
1980,WV,F,11114,862,11976,7.197728790915163
1980,WV,M,8198,5791,13989,41.39681178068482
1980,WY,F,3004,209,3213,6.504824151882975
1980,WY,M,2283,1647,3930,41.908396946564885
1981,AK,F,2647,292,2939,9.935352160598843
1981,AK,M,2320,1706,4026,42.374565325385
1981,AL,F,21257,1476,22733,6.492763823516475
1981,AL,M,17140,9214,26354,34.9624345450406
1981,AR,F,11744,970,12714,7.629384929998427
1981,AR,M,9758,5544,15302,36.230558096980786
1981,AZ,F,18595,1364,19959,6.834009719925847
1981,AZ,M,14418,8791,23209,37.877547503123786
1981,CA,F,169080,12137,181217,6.697495268103985
1981,CA,M,133503,67504,201007,33.58291004790878
1981,CO,F,19195,1572,20767,7.569701930948139
1981,CO,M,14107,9803,23910,40.999581764951905
1981,CT,F,14194,1212,15406,7.867064779955861
1981,CT,M,10134,7713,17847,43.217347453353504
1981,DC,F,5302,464,5766,8.047173083593478
1981,DC,M,5072,2878,7950,36.20125786163522
1981,DE,F,2791,212,3003,7.0596070596070595
1981,DE,M,2111,1685,3796,44.38883034773446
1981,FL,F,50862,3196,54058,5.912168411705945
1981,FL,M,41058,21931,62989,34.81719030306879
1981,GA,F,32646,2174,34820,6.243538196438828
1981,GA,M,26584,13744,40328,34.080539575481055
1981,HI,F,4604,253,4857,5.208976734609841
1981,HI,M,4451,2389,6840,34.92690058479532
1981,IA,F,17988,1413,19401,7.283129735580641
1981,IA,M,12600,9231,21831,42.283908203930196
1981,ID,F,6335,530,6865,7.720320466132556
1981,ID,M,4846,3337,8183,40.77966515947696
1981,IL,F,69961,5169,75130,6.880074537468388
1981,IL,M,53508,31174,84682,36.813018114829596
1981,IN,F,32079,2806,34885,8.043571735703024
1981,IN,M,23947,16194,40141,40.34279165940061
1981,KS,F,14378,1094,15472,7.070837642192347
1981,KS,M,11124,7062,18186,38.83206862421643
1981,KY,F,22094,1774,23868,7.4325456678397845
1981,KY,M,16357,10711,27068,39.57071080242353
1981,LA,F,28877,1743,30620,5.692357935989549
1981,LA,M,25551,11123,36674,30.329388667721002
1981,MA,F,29302,2295,31597,7.263347786182233
1981,MA,M,19680,16087,35767,44.977213632678165
1981,MD,F,19507,1451,20958,6.923370550625059
1981,MD,M,15127,9100,24227,37.56139843975729
1981,ME,F,5729,553,6282,8.802929003502069
1981,ME,M,3772,3265,7037,46.397612619013785
1981,MI,F,54363,4290,58653,7.314203877039538
1981,MI,M,39907,25761,65668,39.22915270755924
1981,MN,F,26798,2296,29094,7.891661510964459
1981,MN,M,18061,14825,32886,45.07997324089278
1981,MO,F,29534,2545,32079,7.933539075407587
1981,MO,M,22219,14422,36641,39.36027946835512
1981,MS,F,14887,950,15837,5.9986108480141445
1981,MS,M,13128,6120,19248,31.795511221945137
1981,MT,F,4333,412,4745,8.68282402528978
1981,MT,M,3423,2406,5829,41.27637673700463
1981,NC,F,30897,2241,33138,6.762629005975014
1981,NC,M,24196,13654,37850,36.07397622192867
1981,ND,F,4577,315,4892,6.439084219133279
1981,ND,M,3544,2342,5886,39.789330615018685
1981,NE,F,10128,759,10887,6.9716175254891155
1981,NE,M,7177,5192,12369,41.97590751071226
1981,NH,F,4862,485,5347,9.070506826257715
1981,NH,M,3328,2824,6152,45.9037711313394
1981,NJ,F,35188,2066,37254,5.54571321200408
1981,NJ,M,26220,16231,42451,38.23467056135309
1981,NM,F,8643,674,9317,7.234088225823763
1981,NM,M,7018,4138,11156,37.09214772319827
1981,NV,F,4097,282,4379,6.439826444393697
1981,NV,M,3356,2335,5691,41.029696011245825
1981,NY,F,94819,6451,101270,6.370099733385998
1981,NY,M,70385,43221,113606,38.044645529285425
1981,OH,F,66839,5406,72245,7.482870786905668
1981,OH,M,48350,32335,80685,40.075602652289774
1981,OK,F,18575,1521,20096,7.568670382165606
1981,OK,M,15200,8366,23566,35.50029703810574
1981,OR,F,15553,1420,16973,8.36622871619631
1981,OR,M,11998,8147,20145,40.44179697195334
1981,PA,F,64916,4415,69331,6.368002769323968
1981,PA,M,45072,32398,77470,41.820059377823675
1981,RI,F,4138,311,4449,6.990334906720612
1981,RI,M,3019,2699,5718,47.20181881776845
1981,SC,F,16795,1150,17945,6.408470325996099
1981,SC,M,14050,7083,21133,33.5163015189514
1981,SD,F,4187,301,4488,6.706773618538324
1981,SD,M,3193,2237,5430,41.19705340699816
1981,TN,F,25719,2168,27887,7.774231720873526
1981,TN,M,20110,12305,32415,37.96082060774333
1981,TX,F,115265,8431,123696,6.815903505367999
1981,TX,M,92617,45188,137805,32.791263016581404
1981,UT,F,15109,1025,16134,6.3530432626750954
1981,UT,M,11755,7264,19019,38.193385561806615
1981,VA,F,27805,2245,30050,7.470881863560733
1981,VA,M,21340,13268,34608,38.337956541840036
1981,VT,F,2392,248,2640,9.393939393939393
1981,VT,M,1703,1512,3215,47.02954898911353
1981,WA,F,25298,2306,27604,8.353861759165339
1981,WA,M,19083,12737,31820,40.02828409805154
1981,WI,F,28809,2372,31181,7.607196690292165
1981,WI,M,19489,15195,34684,43.80982585630262
1981,WV,F,10648,874,11522,7.585488630446104
1981,WV,M,7464,5482,12946,42.34512590761626
1981,WY,F,2993,298,3291,9.054998480704953
1981,WY,M,2357,1671,4028,41.48460774577954
1982,AK,F,3104,324,3428,9.451575262543757
1982,AK,M,2596,1916,4512,42.4645390070922
1982,AL,F,20320,1536,21856,7.027818448023426
1982,AL,M,16887,9200,26087,35.26660788898685
1982,AR,F,11791,980,12771,7.673635580612324
1982,AR,M,9886,5493,15379,35.71753690096885
1982,AZ,F,18726,1437,20163,7.126915637553935
1982,AZ,M,14822,8847,23669,37.37800498542397
1982,CA,F,173695,11982,185677,6.453141746150573
1982,CA,M,136252,68786,205038,33.5479277012066
1982,CO,F,20311,1738,22049,7.882443648238015
1982,CO,M,15154,10058,25212,39.89370141202602
1982,CT,F,14590,1166,15756,7.400355420157401
1982,CT,M,10462,7631,18093,42.17653236058144
1982,DC,F,5253,486,5739,8.468374281233665
1982,DC,M,4927,2830,7757,36.483176485754804
1982,DE,F,2782,198,2980,6.644295302013423
1982,DE,M,2235,1672,3907,42.79498336319427
1982,FL,F,53129,3543,56672,6.2517645398080175
1982,FL,M,43231,22888,66119,34.61637350837127
1982,GA,F,32603,2267,34870,6.501290507599656
1982,GA,M,26641,13955,40596,34.37530791210956
1982,HI,F,4845,286,5131,5.573962190606119
1982,HI,M,4483,2516,6999,35.94799257036719
1982,IA,F,17467,1347,18814,7.159562028276816
1982,IA,M,12156,9128,21284,42.88667543694794
1982,ID,F,6416,455,6871,6.622034638335031
1982,ID,M,4884,3319,8203,40.46080702182128
1982,IL,F,69306,5091,74397,6.843017863623533
1982,IL,M,53068,30836,83904,36.75152555301297
1982,IN,F,32273,2901,35174,8.247569227270143
1982,IN,M,23881,15767,39648,39.767453591606134
1982,KS,F,14317,1199,15516,7.727507089456045
1982,KS,M,10982,6930,17912,38.68914694059848
1982,KY,F,21873,1871,23744,7.879885444743935
1982,KY,M,16405,10390,26795,38.77589102444486
1982,LA,F,29768,1908,31676,6.023487814117944
1982,LA,M,26475,11329,37804,29.967728282721406
1982,MA,F,30142,2413,32555,7.4120718783597
1982,MA,M,20165,16131,36296,44.44291381970465
1982,MD,F,20777,1507,22284,6.762699694848322
1982,MD,M,15961,9671,25632,37.73018102372035
1982,ME,F,5672,566,6238,9.073420968259057
1982,ME,M,3965,3207,7172,44.71556051310653
1982,MI,F,53442,4155,57597,7.213917391530809
1982,MI,M,39734,25242,64976,38.84819010096036
1982,MN,F,26741,2501,29242,8.552766568634157
1982,MN,M,18060,14751,32811,44.957483770686665
1982,MO,F,29695,2490,32185,7.736523225104862
1982,MO,M,22313,14482,36795,39.35860850659057
1982,MS,F,14910,1076,15986,6.730889528337296
1982,MS,M,13105,6147,19252,31.92915021815915
1982,MT,F,4454,402,4856,8.278418451400329
1982,MT,M,3674,2300,5974,38.50016739203214
1982,NC,F,31783,2404,34187,7.031912715359639
1982,NC,M,24629,13874,38503,36.03355582681869
1982,ND,F,4662,318,4980,6.385542168674699
1982,ND,M,3660,2407,6067,39.67364430525795
1982,NE,F,9969,794,10763,7.377125336802007
1982,NE,M,7043,5125,12168,42.11867192636423
1982,NH,F,5072,464,5536,8.38150289017341
1982,NH,M,3381,2935,6316,46.469284357188094
1982,NJ,F,36117,2123,38240,5.551778242677824
1982,NJ,M,27183,16812,43995,38.21343334469826
1982,NM,F,9028,665,9693,6.860621066749201
1982,NM,M,7314,4289,11603,36.96457812634664
1982,NV,F,4457,311,4768,6.522651006711409
1982,NV,M,3456,2379,5835,40.77120822622108
1982,NY,F,95960,6735,102695,6.5582550270217626
1982,NY,M,72038,43953,115991,37.89345725099361
1982,OH,F,66006,5431,71437,7.602502904657251
1982,OH,M,47612,31470,79082,39.794137730456995
1982,OK,F,20986,1578,22564,6.993440879276724
1982,OK,M,16721,9139,25860,35.34029389017788
1982,OR,F,14937,1408,16345,8.614255123891098
1982,OR,M,11388,7770,19158,40.5574694644535
1982,PA,F,65316,4562,69878,6.52852113683849
1982,PA,M,45477,32647,78124,41.78869489529466
1982,RI,F,4376,333,4709,7.071565088129114
1982,RI,M,2999,2609,5608,46.5228245363766
1982,SC,F,16712,1192,17904,6.6577301161751565
1982,SC,M,13993,7063,21056,33.5438829787234
1982,SD,F,4353,389,4742,8.203289751159847
1982,SD,M,3182,2177,5359,40.62325060645643
1982,TN,F,25772,2280,28052,8.127762726365322
1982,TN,M,20195,12442,32637,38.122376443913346
1982,TX,F,121018,8858,129876,6.820351720102251
1982,TX,M,97433,46776,144209,32.436255712195496
1982,UT,F,15365,1029,16394,6.27668659265585
1982,UT,M,12134,7081,19215,36.85141816289357
1982,VA,F,28466,2329,30795,7.5629160578015915
1982,VA,M,21842,13453,35295,38.11588043632243
1982,VT,F,2509,269,2778,9.683225341972642
1982,VT,M,1712,1492,3204,46.566791510611736
1982,WA,F,25283,2225,27508,8.08855605641995
1982,WA,M,19345,12328,31673,38.92274176743599
1982,WI,F,29035,2378,31413,7.570114283895204
1982,WI,M,19627,15104,34731,43.48852610060177
1982,WV,F,10421,885,11306,7.82770210507695
1982,WV,M,7292,5413,12705,42.60527351436442
1982,WY,F,3130,210,3340,6.287425149700598
1982,WY,M,2334,1734,4068,42.62536873156343
1983,AK,F,3438,364,3802,9.573908469226723
1983,AK,M,2793,1930,4723,40.863857717552406
1983,AL,F,20234,1537,21771,7.0598502595195445
1983,AL,M,16443,9145,25588,35.7394090980147
1983,AR,F,11988,957,12945,7.3928157589803005
1983,AR,M,9678,5492,15170,36.20303230059327
1983,AZ,F,19009,1377,20386,6.75463553419013
1983,AZ,M,14891,8903,23794,37.41699588131462
1983,CA,F,175645,11975,187620,6.382581814305512
1983,CA,M,137501,69520,207021,33.58113428106327
1983,CO,F,20191,1623,21814,7.4401760337397995
1983,CO,M,15319,9813,25132,39.04583797548942
1983,CT,F,14599,1190,15789,7.53689277344987
1983,CT,M,10715,7912,18627,42.47597573414935
1983,DC,F,5268,449,5717,7.853769459506735
1983,DC,M,4764,2801,7565,37.02577660277594
1983,DE,F,2713,208,2921,7.120849024306744
1983,DE,M,2218,1671,3889,42.967343790177424
1983,FL,F,55216,3616,58832,6.146314930649986
1983,FL,M,44478,23649,68127,34.71310933990929
1983,GA,F,32857,2250,35107,6.40897826644259
1983,GA,M,26618,13927,40545,34.349488222962144
1983,HI,F,5043,339,5382,6.298773690078038
1983,HI,M,4807,2507,7314,34.276729559748425
1983,IA,F,17034,1345,18379,7.31813482779259
1983,IA,M,11824,8641,20465,42.22330808697777
1983,ID,F,5947,429,6376,6.728356336260978
1983,ID,M,4740,3206,7946,40.34734457588724
1983,IL,F,67838,4930,72768,6.774956024626209
1983,IL,M,51116,30701,81817,37.52398645758216
1983,IN,F,31132,2676,33808,7.915286322763842
1983,IN,M,22826,15117,37943,39.84134095880663
1983,KS,F,14390,1154,15544,7.424086464230571
1983,KS,M,10795,6966,17761,39.22076459658803
1983,KY,F,20707,1818,22525,8.07103218645949
1983,KY,M,15550,10064,25614,39.291012727414696
1983,LA,F,28908,1849,30757,6.011639626751633
1983,LA,M,25502,11190,36692,30.497111086885425
1983,MA,F,30450,2372,32822,7.226860032904758
1983,MA,M,20082,16326,36408,44.841793012524725
1983,MD,F,20966,1558,22524,6.917066240454626
1983,MD,M,16047,9934,25981,38.23563373234287
1983,ME,F,5686,554,6240,8.878205128205128
1983,ME,M,3962,3210,7172,44.757389849414395
1983,MI,F,51212,4017,55229,7.273352767567763
1983,MI,M,38211,24397,62608,38.967863531817024
1983,MN,F,25702,2264,27966,8.095544589859115
1983,MN,M,17334,13978,31312,44.641032192130815
1983,MO,F,29303,2613,31916,8.187116179972428
1983,MO,M,21833,14034,35867,39.127889146011654
1983,MS,F,14275,967,15242,6.344311770108909
1983,MS,M,12275,5862,18137,32.32067045266582
1983,MT,F,4367,336,4703,7.144375930257282
1983,MT,M,3482,2286,5768,39.632454923717056
1983,NC,F,30979,2379,33358,7.131722525331255
1983,NC,M,23931,14075,38006,37.03362626953639
1983,ND,F,4546,348,4894,7.110747854515734
1983,ND,M,3349,2365,5714,41.38956947847392
1983,NE,F,9610,709,10319,6.870820815970539
1983,NE,M,7084,4940,12024,41.084497671324016
1983,NH,F,4793,456,5249,8.687369022670985
1983,NH,M,3450,2760,6210,44.44444444444444
1983,NJ,F,36109,2111,38220,5.523286237571952
1983,NJ,M,26808,17050,43858,38.87546171736057
1983,NM,F,8765,686,9451,7.258491164956089
1983,NM,M,7255,4428,11683,37.901224000684756
1983,NV,F,4221,294,4515,6.511627906976744
1983,NV,M,3431,2357,5788,40.722183828610916
1983,NY,F,96312,6506,102818,6.327685813768018
1983,NY,M,72380,44348,116728,37.992598176958396
1983,OH,F,63430,5408,68838,7.856125976931345
1983,OH,M,45483,30603,76086,40.22159135714849
1983,OK,F,20212,1606,21818,7.360894674122284
1983,OK,M,16162,8908,25070,35.53250897487036
1983,OR,F,14661,1313,15974,8.219606861149368
1983,OR,M,10910,7532,18442,40.841557314824854
1983,PA,F,63398,4547,67945,6.6921774965045255
1983,PA,M,44895,31812,76707,41.47209511517854
1983,RI,F,4431,308,4739,6.499261447562777
1983,RI,M,2993,2714,5707,47.5556334326266
1983,SC,F,16579,1189,17768,6.691805493021162
1983,SC,M,13613,7130,20743,34.3730415079786
1983,SD,F,4088,328,4416,7.427536231884058
1983,SD,M,3099,2215,5314,41.682348513360935
1983,TN,F,25291,2284,27575,8.28286491387126
1983,TN,M,19603,12250,31853,38.45791605186324
1983,TX,F,119516,8744,128260,6.817402151878996
1983,TX,M,94930,47217,142147,33.217021815444575
1983,UT,F,14481,929,15410,6.028552887735237
1983,UT,M,11516,6699,18215,36.777381279165525
1983,VA,F,28449,2316,30765,7.528035104826913
1983,VA,M,21454,13534,34988,38.68183377157883
1983,VT,F,2473,259,2732,9.480234260614933
1983,VT,M,1834,1462,3296,44.35679611650485
1983,WA,F,25101,2168,27269,7.950419890718398
1983,WA,M,19250,12295,31545,38.97606593754953
1983,WI,F,28230,2253,30483,7.391004822360003
1983,WI,M,19062,14802,33864,43.710134656272146
1983,WV,F,9853,849,10702,7.933096617454681
1983,WV,M,7157,5267,12424,42.39375402446877
1983,WY,F,2823,221,3044,7.26018396846255
1983,WY,M,2264,1639,3903,41.99333845759672
1984,AK,F,3608,353,3961,8.911890936632163
1984,AK,M,2993,2005,4998,40.11604641856742
1984,AL,F,19960,1568,21528,7.283537718320327
1984,AL,M,16205,9168,25373,36.13289717416151
1984,AR,F,11741,1033,12774,8.086738687959919
1984,AR,M,9707,5485,15192,36.10452869931543
1984,AZ,F,19623,1461,21084,6.92942515651679
1984,AZ,M,15770,9095,24865,36.57751860044239
1984,CA,F,180356,12175,192531,6.323656969526985
1984,CA,M,141788,70615,212403,33.24576394872012
1984,CO,F,20041,1597,21638,7.380534245309178
1984,CO,M,15254,9663,24917,38.78075209696191
1984,CT,F,15146,1189,16335,7.278849097030915
1984,CT,M,11009,8161,19170,42.5717266562337
1984,DC,F,5226,442,5668,7.79816513761468
1984,DC,M,4954,2608,7562,34.4882306268183
1984,DE,F,2823,211,3034,6.9545154911008575
1984,DE,M,2174,1728,3902,44.2849820604818
1984,FL,F,57910,3720,61630,6.036021418140516
1984,FL,M,46442,24757,71199,34.771555780277815
1984,GA,F,33223,2451,35674,6.870549980377866
1984,GA,M,27316,14381,41697,34.489291795572825
1984,HI,F,4958,306,5264,5.813069908814589
1984,HI,M,4444,2617,7061,37.06273898881178
1984,IA,F,16511,1262,17773,7.1006583019186404
1984,IA,M,11749,8408,20157,41.71255643200873
1984,ID,F,5672,421,6093,6.909568357131134
1984,ID,M,4795,2891,7686,37.61384335154827
1984,IL,F,67755,4840,72595,6.6671258351126115
1984,IL,M,51578,30321,81899,37.022430066301176
1984,IN,F,30597,2689,33286,8.07847142942979
1984,IN,M,22987,14834,37821,39.221596467570926
1984,KS,F,14143,1136,15279,7.435041560311539
1984,KS,M,10820,6626,17446,37.980052734151094
1984,KY,F,20137,1792,21929,8.171827260705003
1984,KY,M,14918,9727,24645,39.46845201866505
1984,LA,F,28835,1898,30733,6.175771971496437
1984,LA,M,25018,10865,35883,30.278962182649167
1984,MA,F,31013,2443,33456,7.3021281683405075
1984,MA,M,20822,16574,37396,44.320248154882876
1984,MD,F,21242,1637,22879,7.1550329996940425
1984,MD,M,16519,10185,26704,38.140353505092875
1984,ME,F,5699,532,6231,8.53795538436848
1984,ME,M,4141,3179,7320,43.42896174863388
1984,MI,F,52409,3925,56334,6.967373167181454
1984,MI,M,39255,24482,63737,38.410970080173215
1984,MN,F,26363,2287,28650,7.982547993019197
1984,MN,M,17469,14159,31628,44.76729480207411
1984,MO,F,28906,2446,31352,7.8017351365144165
1984,MO,M,21831,13826,35657,38.774995092127774
1984,MS,F,14038,1001,15039,6.656027661413658
1984,MS,M,11980,5864,17844,32.86258686393185
1984,MT,F,4335,344,4679,7.351998290232956
1984,MT,M,3592,2219,5811,38.18619858888315
1984,NC,F,31653,2424,34077,7.113302227308742
1984,NC,M,24635,14468,39103,36.99971869166049
1984,ND,F,4443,329,4772,6.894383906119028
1984,ND,M,3254,2215,5469,40.50100566831231
1984,NE,F,9680,732,10412,7.030349596619286
1984,NE,M,6974,4951,11925,41.517819706498955
1984,NH,F,4923,422,5345,7.8952291861552855
1984,NH,M,3546,2890,6436,44.90366687383468
1984,NJ,F,36943,2162,39105,5.528704769211099
1984,NJ,M,27041,17288,44329,38.999300683525455
1984,NM,F,9120,690,9810,7.033639143730887
1984,NM,M,7145,4260,11405,37.35203857957036
1984,NV,F,4416,259,4675,5.540106951871658
1984,NV,M,3746,2367,6113,38.720759038115496
1984,NY,F,97781,6492,104273,6.2259645354022615
1984,NY,M,72552,44316,116868,37.91970428175377
1984,OH,F,63799,5358,69157,7.747588819642264
1984,OH,M,46492,30080,76572,39.283288930679625
1984,OK,F,19187,1476,20663,7.143202826307893
1984,OK,M,15787,8319,24106,34.51008047788932
1984,OR,F,14347,1306,15653,8.343448540215933
1984,OR,M,11318,7380,18698,39.46946197454273
1984,PA,F,63510,4502,68012,6.619420102334882
1984,PA,M,44570,31204,75774,41.18035209966479
1984,RI,F,4323,333,4656,7.1520618556701026
1984,RI,M,3181,2625,5806,45.21184981054082
1984,SC,F,16357,1270,17627,7.204856186532024
1984,SC,M,13549,7050,20599,34.22496237681441
1984,SD,F,4094,276,4370,6.315789473684211
1984,SD,M,3029,2218,5247,42.271774347246044
1984,TN,F,25270,2165,27435,7.891379624567159
1984,TN,M,19587,11825,31412,37.644849102253914
1984,TX,F,121285,9089,130374,6.971482043965821
1984,TX,M,95352,47430,142782,33.21847291675421
1984,UT,F,14031,904,14935,6.052895882156009
1984,UT,M,11344,6262,17606,35.567420197659885
1984,VA,F,28988,2366,31354,7.546086623716272
1984,VA,M,22217,13732,35949,38.19855906979332
1984,VT,F,2509,253,2762,9.160028964518464
1984,VT,M,1853,1422,3275,43.41984732824427
1984,WA,F,24824,2025,26849,7.542180341912176
1984,WA,M,19393,11979,31372,38.18373071528752
1984,WI,F,28477,2146,30623,7.007804591320249
1984,WI,M,19509,14529,34038,42.684646571478936
1984,WV,F,9172,804,9976,8.05934242181235
1984,WV,M,6773,4987,11760,42.406462585034014
1984,WY,F,2692,229,2921,7.839780896953099
1984,WY,M,2154,1518,3672,41.33986928104575
1985,AK,F,3594,382,3976,9.60764587525151
1985,AK,M,3012,2045,5057,40.438995451848925
1985,AL,F,20262,1525,21787,6.999586909625005
1985,AL,M,16805,8751,25556,34.242447957426826
1985,AR,F,11701,1003,12704,7.895151133501259
1985,AR,M,9911,5363,15274,35.1119549561346
1985,AZ,F,21422,1549,22971,6.743285011536285
1985,AZ,M,16879,9588,26467,36.22624400196471
1985,CA,F,189689,12439,202128,6.1540212142800605
1985,CA,M,151127,72289,223416,32.35623231997708
1985,CO,F,20398,1559,21957,7.100241380880812
1985,CO,M,15611,9578,25189,38.02453451903609
1985,CT,F,15858,1168,17026,6.860096323270293
1985,CT,M,11809,8118,19927,40.73869624128068
1985,DC,F,5212,474,5686,8.33626450932114
1985,DC,M,5050,2664,7714,34.534612393051596
1985,DE,F,2879,188,3067,6.129768503423541
1985,DE,M,2269,1752,4021,43.571250932603824
1985,FL,F,61257,3966,65223,6.080677061772687
1985,FL,M,49377,25215,74592,33.803893178893176
1985,GA,F,34500,2588,37088,6.977998274374461
1985,GA,M,28679,14515,43194,33.60420428763254
1985,HI,F,4580,323,4903,6.587803385682236
1985,HI,M,4472,2380,6852,34.7343841214244
1985,IA,F,16048,1198,17246,6.9465383277281685
1985,IA,M,11687,7689,19376,39.68311312964492
1985,ID,F,5569,434,6003,7.229718474096285
1985,ID,M,4528,2706,7234,37.40669062759193
1985,IL,F,68079,4895,72974,6.707868555924028
1985,IL,M,52693,29589,82282,35.96047738265963
1985,IN,F,31528,2511,34039,7.376832456887687
1985,IN,M,23215,14479,37694,38.411948851276065
1985,KS,F,13603,1049,14652,7.15943215943216
1985,KS,M,10898,6458,17356,37.20903433970961
1985,KY,F,19622,1631,21253,7.67421069966593
1985,KY,M,15261,9571,24832,38.543009020618555
1985,LA,F,28142,1930,30072,6.417930300611865
1985,LA,M,24967,10890,35857,30.370638926848315
1985,MA,F,32525,2433,34958,6.959780307797929
1985,MA,M,22263,16944,39207,43.2167725151121
1985,MD,F,22391,1719,24110,7.129821650767316
1985,MD,M,17591,10155,27746,36.59987025156779
1985,ME,F,5885,477,6362,7.497642250864509
1985,ME,M,4112,3109,7221,43.05497853482897
1985,MI,F,53219,4011,57230,7.008561943036868
1985,MI,M,41059,24111,65170,36.99708454810496
1985,MN,F,26387,2155,28542,7.550276785088641
1985,MN,M,17952,13703,31655,43.28858000315906
1985,MO,F,29722,2462,32184,7.649763857817549
1985,MO,M,22862,14041,36903,38.04839714928326
1985,MS,F,13703,1030,14733,6.99110839611756
1985,MS,M,11776,5595,17371,32.20885383685453
1985,MT,F,4070,301,4371,6.88629604209563
1985,MT,M,3493,2047,5540,36.94945848375451
1985,NC,F,32877,2659,35536,7.482552904097253
1985,NC,M,25941,14587,40528,35.99240031583103
1985,ND,F,4264,332,4596,7.2236727589208005
1985,ND,M,3329,2194,5523,39.72478725330436
1985,NE,F,9330,674,10004,6.737305077968812
1985,NE,M,7016,4696,11712,40.095628415300546
1985,NH,F,5465,459,5924,7.74814314652262
1985,NH,M,3782,3084,6866,44.91698223128459
1985,NJ,F,38068,2337,40405,5.783937631481252
1985,NJ,M,28936,17602,46538,37.82285444153165
1985,NM,F,8978,620,9598,6.459679099812461
1985,NM,M,7252,4361,11613,37.552742616033754
1985,NV,F,4505,299,4804,6.223980016652789
1985,NV,M,3827,2365,6192,38.19444444444444
1985,NY,F,100279,6521,106800,6.105805243445693
1985,NY,M,75398,45603,121001,37.688118280014216
1985,OH,F,64005,5056,69061,7.321063986910123
1985,OH,M,47596,29529,77125,38.2871961102107
1985,OK,F,18573,1538,20111,7.647556063845657
1985,OK,M,15435,8172,23607,34.61685093404498
1985,OR,F,14432,1204,15636,7.7001790739319524
1985,OR,M,11262,6949,18211,38.15825599912141
1985,PA,F,64597,4511,69108,6.527464258841234
1985,PA,M,46079,30978,77057,40.20140934632804
1985,RI,F,4502,308,4810,6.403326403326403
1985,RI,M,3336,2615,5951,43.942194589144684
1985,SC,F,16552,1279,17831,7.172901127250294
1985,SC,M,14156,7204,21360,33.72659176029963
1985,SD,F,3867,266,4133,6.436002903459956
1985,SD,M,3018,2104,5122,41.07770402186646
1985,TN,F,25470,2297,27767,8.272409694961645
1985,TN,M,20333,11915,32248,36.94802778466882
1985,TX,F,123960,9325,133285,6.996286153730727
1985,TX,M,99337,47788,147125,32.48122344944775
1985,UT,F,13505,842,14347,5.86882275040078
1985,UT,M,11099,5915,17014,34.76548724579758
1985,VA,F,30528,2402,32930,7.294260552687519
1985,VA,M,23575,14222,37797,37.627324919967194
1985,VT,F,2468,248,2716,9.131075110456553
1985,VT,M,1837,1486,3323,44.71862774601264
1985,WA,F,25580,2056,27636,7.439571573310174
1985,WA,M,19834,11701,31535,37.10480418582527
1985,WI,F,28543,2083,30626,6.801410566185593
1985,WI,M,20106,14069,34175,41.167520117044624
1985,WV,F,9078,747,9825,7.603053435114504
1985,WV,M,6858,4725,11583,40.79254079254079
1985,WY,F,2578,180,2758,6.526468455402465
1985,WY,M,2101,1358,3459,39.259901705695285
1986,AK,F,3364,355,3719,9.545576767948374
1986,AK,M,2924,1845,4769,38.6873558397987
1986,AL,F,19751,1572,21323,7.372320967968859
1986,AL,M,16691,8602,25293,34.009409718103825
1986,AR,F,11393,1021,12414,8.224585145803125
1986,AR,M,9629,5137,14766,34.789381010429366
1986,AZ,F,21826,1592,23418,6.798189426936545
1986,AZ,M,17704,9507,27211,34.93807651317482
1986,CA,F,194440,13134,207574,6.327382042066926
1986,CA,M,155465,72875,228340,31.915126565647718
1986,CO,F,20212,1617,21829,7.4075770763663025
1986,CO,M,15625,9554,25179,37.944318678263635
1986,CT,F,16165,1154,17319,6.663202263410127
1986,CT,M,11970,8349,20319,41.08962055219253
1986,DC,F,5146,485,5631,8.61303498490499
1986,DC,M,4850,2648,7498,35.316084289143774
1986,DE,F,2931,246,3177,7.743153918791313
1986,DE,M,2322,1646,3968,41.48185483870967
1986,FL,F,62255,4140,66395,6.235409292868439
1986,FL,M,50872,25486,76358,33.37698734906624
1986,GA,F,34979,2687,37666,7.133754579727075
1986,GA,M,29470,14710,44180,33.29560887279312
1986,HI,F,4586,286,4872,5.870279146141215
1986,HI,M,4164,2332,6496,35.899014778325125
1986,IA,F,14780,1160,15940,7.277289836888332
1986,IA,M,11076,7066,18142,38.94829676992614
1986,ID,F,5191,361,5552,6.502161383285303
1986,ID,M,4237,2579,6816,37.837441314553985
1986,IL,F,66136,4786,70922,6.748258650348269
1986,IL,M,51695,28127,79822,35.23715266467891
1986,IN,F,30331,2518,32849,7.665377941489846
1986,IN,M,23132,13836,36968,37.42696386063623
1986,KS,F,13346,1146,14492,7.907811206182721
1986,KS,M,10965,6284,17249,36.431097454924924
1986,KY,F,19216,1735,20951,8.281227626366283
1986,KY,M,15033,8894,23927,37.17139633050529
1986,LA,F,26292,1909,28201,6.76926350129428
1986,LA,M,24071,9975,34046,29.298596017153262
1986,MA,F,32632,2438,35070,6.951810664385515
1986,MA,M,22604,16637,39241,42.3969827476364
1986,MD,F,22634,1883,24517,7.680385038952564
1986,MD,M,18080,10216,28296,36.104042974271984
1986,ME,F,5636,458,6094,7.515589104036757
1986,ME,M,4097,3150,7247,43.46626190147647
1986,MI,F,52475,4037,56512,7.143615515288788
1986,MI,M,40284,23557,63841,36.89948465719522
1986,MN,F,25471,2190,27661,7.917284263041828
1986,MN,M,17742,13015,30757,42.3155704392496
1986,MO,F,28848,2550,31398,8.121536403592586
1986,MO,M,22619,13345,35964,37.10655099543988
1986,MS,F,12815,934,13749,6.793221325187286
1986,MS,M,11687,5393,17080,31.574941451990636
1986,MT,F,3597,290,3887,7.460766658091073
1986,MT,M,3202,2012,5214,38.58841580360568
1986,NC,F,32939,2607,35546,7.334158555111686
1986,NC,M,26672,14207,40879,34.75378556226914
1986,ND,F,3966,296,4262,6.9450961989676205
1986,ND,M,3104,2042,5146,39.68130586863584
1986,NE,F,8813,705,9518,7.407018281151502
1986,NE,M,6811,4318,11129,38.799532752268846
1986,NH,F,5493,504,5997,8.404202101050526
1986,NH,M,4055,2931,6986,41.95533924992843
1986,NJ,F,39653,2329,41982,5.547615644800152
1986,NJ,M,29506,18077,47583,37.990458777294414
1986,NM,F,8817,655,9472,6.915118243243243
1986,NM,M,7148,4219,11367,37.116213600774174
1986,NV,F,4743,330,5073,6.505026611472502
1986,NV,M,4041,2338,6379,36.651512776297224
1986,NY,F,101512,6867,108379,6.336098321630574
1986,NY,M,76912,45259,122171,37.04561639014169
1986,OH,F,62742,5174,67916,7.618234289416338
1986,OH,M,47195,28326,75521,37.50744825942453
1986,OK,F,17310,1464,18774,7.7980185362735694
1986,OK,M,14985,7497,22482,33.3466773418735
1986,OR,F,14102,1252,15354,8.154226911553993
1986,OR,M,11117,6864,17981,38.17362771814693
1986,PA,F,63991,4723,68714,6.873417353086706
1986,PA,M,46801,30404,77205,39.38086911469465
1986,RI,F,4717,342,5059,6.760229294326941
1986,RI,M,3373,2606,5979,43.58588392707811
1986,SC,F,16446,1254,17700,7.084745762711863
1986,SC,M,13978,7103,21081,33.69384754043926
1986,SD,F,3775,283,4058,6.973878758008871
1986,SD,M,2893,1883,4776,39.426298157453935
1986,TN,F,25250,2293,27543,8.325164288566969
1986,TN,M,20082,11232,31314,35.86894041004024
1986,TX,F,122270,9321,131591,7.083311168696947
1986,TX,M,99394,46878,146272,32.0485123605338
1986,UT,F,13156,810,13966,5.799799513103251
1986,UT,M,10935,5570,16505,33.74734928809452
1986,VA,F,31182,2529,33711,7.502002313784819
1986,VA,M,23923,13898,37821,36.74678088892414
1986,VT,F,2494,224,2718,8.241353936718175
1986,VT,M,1851,1474,3325,44.33082706766917
1986,WA,F,25154,2033,27187,7.477838672895134
1986,WA,M,19901,11417,31318,36.45507375949933
1986,WI,F,27537,2115,29652,7.132739781464995
1986,WI,M,19760,13449,33209,40.498057755427745
1986,WV,F,8679,761,9440,8.061440677966102
1986,WV,M,6649,4469,11118,40.19607843137255
1986,WY,F,2207,177,2384,7.424496644295302
1986,WY,M,1837,1282,3119,41.10291760179545
1987,AK,F,3251,323,3574,9.037493005036373
1987,AK,M,2752,1693,4445,38.087739032620924
1987,AL,F,19916,1618,21534,7.513699266276586
1987,AL,M,16842,8480,25322,33.488665982149904
1987,AR,F,11236,1028,12264,8.382257012393998
1987,AR,M,9885,5065,14950,33.87959866220736
1987,AZ,F,22865,1551,24416,6.352391874180865
1987,AZ,M,18656,9716,28372,34.245030311574794
1987,CA,F,201787,13232,215019,6.1538747738571935
1987,CA,M,163815,74989,238804,31.40190281569823
1987,CO,F,19387,1597,20984,7.610560426991994
1987,CO,M,15514,9045,24559,36.829675475385805
1987,CT,F,16985,1249,18234,6.849840956454973
1987,CT,M,12728,8641,21369,40.43708175394263
1987,DC,F,5189,492,5681,8.660447104383032
1987,DC,M,5313,2698,8011,33.67869179877668
1987,DE,F,3161,260,3421,7.600116924875768
1987,DE,M,2336,1779,4115,43.23207776427703
1987,FL,F,65162,4228,69390,6.0930969880386225
1987,FL,M,53196,26288,79484,33.073322932917314
1987,GA,F,36377,2806,39183,7.161268917642856
1987,GA,M,30481,15054,45535,33.060283298561544
1987,HI,F,4537,312,4849,6.434316353887399
1987,HI,M,4443,2309,6752,34.197274881516584
1987,IA,F,14567,1066,15633,6.818908718736007
1987,IA,M,10754,6964,17718,39.304661925725256
1987,ID,F,4846,343,5189,6.610136827905184
1987,ID,M,4145,2411,6556,36.77547284929835
1987,IL,F,67598,4953,72551,6.82692175159543
1987,IL,M,53286,28437,81723,34.796813626518855
1987,IN,F,29536,2568,32104,7.999003239471716
1987,IN,M,23163,13794,36957,37.32445815407095
1987,KS,F,13075,1145,14220,8.052039381153305
1987,KS,M,10722,5812,16534,35.15180839482279
1987,KY,F,19201,1674,20875,8.019161676646707
1987,KY,M,14957,8936,23893,37.40007533587243
1987,LA,F,24487,1814,26301,6.897076156800122
1987,LA,M,22723,9432,32155,29.332918675167157
1987,MA,F,33349,2519,35868,7.022973123675699
1987,MA,M,23746,17045,40791,41.78617832364983
1987,MD,F,23593,1901,25494,7.456656468188594
1987,MD,M,18713,10399,29112,35.72066501786205
1987,ME,F,5689,501,6190,8.093699515347334
1987,ME,M,4084,3065,7149,42.87312910896629
1987,MI,F,53930,4024,57954,6.943437899023364
1987,MI,M,41418,23242,64660,35.94494277760594
1987,MN,F,24879,2104,26983,7.797502130971353
1987,MN,M,17776,12746,30522,41.760041936963496
1987,MO,F,28834,2403,31237,7.692800204885232
1987,MO,M,22546,13202,35748,36.93073738390959
1987,MS,F,12360,940,13300,7.067669172932331
1987,MS,M,11363,5011,16374,30.603395627213875
1987,MT,F,3571,254,3825,6.640522875816994
1987,MT,M,3049,1870,4919,38.015856881479976
1987,NC,F,34407,2841,37248,7.627255154639176
1987,NC,M,27014,14517,41531,34.95461221737979
1987,ND,F,3706,280,3986,7.024586051179127
1987,ND,M,3081,1929,5010,38.50299401197605
1987,NE,F,8538,690,9228,7.477243172951886
1987,NE,M,6559,4126,10685,38.61488067384183
1987,NH,F,5782,553,6335,8.729281767955802
1987,NH,M,4361,3218,7579,42.45942736508774
1987,NJ,F,41264,2284,43548,5.244787361072839
1987,NJ,M,31158,18748,49906,37.566625255480304
1987,NM,F,8861,649,9510,6.8243953732912725
1987,NM,M,7269,4110,11379,36.119166886369634
1987,NV,F,4936,371,5307,6.990766911626155
1987,NV,M,4329,2468,6797,36.31013682506988
1987,NY,F,104767,7024,111791,6.283153384440608
1987,NY,M,80376,45201,125577,35.99464870159345
1987,OH,F,62549,5137,67686,7.589457199420855
1987,OH,M,48025,28278,76303,37.060141803074586
1987,OK,F,16498,1418,17916,7.914713105603929
1987,OK,M,13622,7161,20783,34.45604580666891
1987,OR,F,14106,1199,15305,7.834041163018621
1987,OR,M,11189,6562,17751,36.96693144048223
1987,PA,F,64578,4621,69199,6.67784216534921
1987,PA,M,47396,30194,77590,38.914808609356875
1987,RI,F,4888,334,5222,6.396016851780926
1987,RI,M,3483,2734,6217,43.97619430593534
1987,SC,F,16837,1329,18166,7.315864802378069
1987,SC,M,14318,7108,21426,33.17464762438159
1987,SD,F,3747,310,4057,7.6411141237367515
1987,SD,M,2911,1825,4736,38.53462837837838
1987,TN,F,25876,2336,28212,8.280164469020274
1987,TN,M,20678,11558,32236,35.854324357860776
1987,TX,F,119604,9209,128813,7.149123147508403
1987,TX,M,97604,45768,143372,31.92255112574282
1987,UT,F,12556,836,13392,6.242532855436081
1987,UT,M,10483,5352,15835,33.798547521313544
1987,VA,F,32108,2611,34719,7.520377891068292
1987,VA,M,25207,14233,39440,36.08772819472617
1987,VT,F,2436,233,2669,8.729861371300112
1987,VT,M,1903,1398,3301,42.35080278703423
1987,WA,F,25082,2107,27189,7.749457501195336
1987,WA,M,20325,11393,31718,35.919667066019294
1987,WI,F,26803,2125,28928,7.345824115044247
1987,WI,M,19538,12890,32428,39.749599111878624
1987,WV,F,8326,746,9072,8.22310405643739
1987,WV,M,6430,4157,10587,39.26513648814584
1987,WY,F,1861,151,2012,7.504970178926442
1987,WY,M,1507,1116,2623,42.546702249332824
1988,AK,F,3000,271,3271,8.284928156527057
1988,AK,M,2617,1705,4322,39.44932901434521
1988,AL,F,19879,1731,21610,8.010180472003702
1988,AL,M,17367,8464,25831,32.76683055243699
1988,AR,F,11282,1075,12357,8.699522537832808
1988,AR,M,9691,5010,14701,34.079314332358344
1988,AZ,F,23449,1720,25169,6.833803488418293
1988,AZ,M,19324,10113,29437,34.35472364711078
1988,CA,F,214245,14042,228287,6.151029186944504
1988,CA,M,174088,78156,252244,30.984285057325444
1988,CO,F,19293,1557,20850,7.467625899280575
1988,CO,M,15310,8794,24104,36.483571191503486
1988,CT,F,17438,1300,18738,6.9377735083786956
1988,CT,M,13104,8592,21696,39.60176991150443
1988,DC,F,5660,529,6189,8.54742284698659
1988,DC,M,5565,2727,8292,32.88712011577424
1988,DE,F,3263,238,3501,6.798057697800629
1988,DE,M,2608,1814,4422,41.02216191768431
1988,FL,F,68399,4476,72875,6.142024013722127
1988,FL,M,57283,27097,84380,32.113059966816785
1988,GA,F,36930,3166,40096,7.8960494812450115
1988,GA,M,31599,15093,46692,32.32459521973786
1988,HI,F,4665,309,4974,6.212303980699638
1988,HI,M,4445,2331,6776,34.40082644628099
1988,IA,F,14457,1179,15636,7.540291634689179
1988,IA,M,10973,6733,17706,38.02665763018186
1988,ID,F,4848,378,5226,7.233065442020665
1988,ID,M,3985,2364,6349,37.23421011182864
1988,IL,F,68804,4870,73674,6.610201699378343
1988,IL,M,54709,28734,83443,34.43548290449768
1988,IN,F,31285,2635,33920,7.7682783018867925
1988,IN,M,24780,14030,38810,36.15047668126771
1988,KS,F,13194,1122,14316,7.837384744341995
1988,KS,M,10577,6080,16657,36.501170678993816
1988,KY,F,18737,1716,20453,8.389967241969392
1988,KY,M,14758,8858,23616,37.508468834688344
1988,LA,F,24549,1760,26309,6.689725949294918
1988,LA,M,22306,9264,31570,29.344314222363003
1988,MA,F,34574,2616,37190,7.034148964775477
1988,MA,M,24551,16919,41470,40.79816734989149
1988,MD,F,23875,2089,25964,8.04575566168541
1988,MD,M,19652,10983,30635,35.85115064468745
1988,ME,F,5624,506,6130,8.254486133768351
1988,ME,M,4238,3054,7292,41.88151398793198
1988,MI,F,53452,3959,57411,6.895891031335459
1988,MI,M,41571,23082,64653,35.70135956568141
1988,MN,F,25519,2068,27587,7.496284481821148
1988,MN,M,17953,12734,30687,41.49639912666602
1988,MO,F,29178,2478,31656,7.8278999241849885
1988,MO,M,23330,13175,36505,36.090946445692374
1988,MS,F,12459,1009,13468,7.491832491832493
1988,MS,M,11388,4995,16383,30.488921442959168
1988,MT,F,3225,300,3525,8.51063829787234
1988,MT,M,2909,1702,4611,36.91173281283886
1988,NC,F,35371,2960,38331,7.722209177949963
1988,NC,M,28569,14957,43526,34.36336902081514
1988,ND,F,3761,310,4071,7.614836649471875
1988,ND,M,2821,1824,4645,39.26803013993542
1988,NE,F,8367,682,9049,7.536744391645486
1988,NE,M,6658,4226,10884,38.82763689819919
1988,NH,F,6149,480,6629,7.240911147986122
1988,NH,M,4534,3173,7707,41.17036460360711
1988,NJ,F,42699,2557,45256,5.65007954746332
1988,NJ,M,32446,18976,51422,36.90249309634009
1988,NM,F,8664,650,9314,6.978741679192613
1988,NM,M,7347,4081,11428,35.71053552677634
1988,NV,F,5288,364,5652,6.4401981599433835
1988,NV,M,4669,2535,7204,35.18878400888396
1988,NY,F,107029,6911,113940,6.065473055994383
1988,NY,M,83591,46025,129616,35.50873348969263
1988,OH,F,63319,5276,68595,7.69152270573657
1988,OH,M,48725,28213,76938,36.66978606150407
1988,OK,F,16069,1332,17401,7.654732486638699
1988,OK,M,13884,6839,20723,33.00197847801959
1988,OR,F,14494,1187,15681,7.569670301638926
1988,OR,M,11673,6671,18344,36.36611426079372
1988,PA,F,65110,4766,69876,6.820653729463622
1988,PA,M,48870,30229,79099,38.216665191721766
1988,RI,F,4839,355,5194,6.834809395456295
1988,RI,M,3572,2732,6304,43.33756345177665
1988,SC,F,17393,1333,18726,7.118444942860195
1988,SC,M,15261,7206,22467,32.07370810522099
1988,SD,F,3457,266,3723,7.144775718506581
1988,SD,M,2944,1757,4701,37.37502659008722
1988,TN,F,26380,2529,28909,8.74814071742364
1988,TN,M,22074,11786,33860,34.80803307737744
1988,TX,F,118813,9409,128222,7.338054312052533
1988,TX,M,98569,45468,144037,31.56688906322681
1988,UT,F,12784,782,13566,5.764411027568922
1988,UT,M,10975,5269,16244,32.43659197242059
1988,VA,F,32965,2891,35856,8.0628067826863
1988,VA,M,25829,14265,40094,35.57888960941787
1988,VT,F,2360,258,2618,9.854851031321619
1988,VT,M,1896,1412,3308,42.68440145102781
1988,WA,F,25849,2040,27889,7.314711893578113
1988,WA,M,21098,11514,32612,35.30602232307126
1988,WI,F,26537,2109,28646,7.362284437617818
1988,WI,M,19594,12816,32410,39.54335081764888
1988,WV,F,7961,699,8660,8.071593533487299
1988,WV,M,6372,3978,10350,38.43478260869565
1988,WY,F,1715,135,1850,7.297297297297297
1988,WY,M,1549,1000,2549,39.23107100823853
1989,AK,F,3196,335,3531,9.487397337864628
1989,AK,M,2653,1699,4352,39.03952205882353
1989,AL,F,20765,1899,22664,8.378926932580304
1989,AL,M,18183,8854,27037,32.74771609276177
1989,AR,F,11389,1108,12497,8.866127870688965
1989,AR,M,10304,5037,15341,32.8335832083958
1989,AZ,F,23666,1755,25421,6.903741001534165
1989,AZ,M,20184,10082,30266,33.311306416440885
1989,CA,F,228612,15286,243898,6.267374066208005
1989,CA,M,187267,81469,268736,30.315625744224818
1989,CO,F,18932,1658,20590,8.052452646915977
1989,CO,M,15603,8586,24189,35.495473148952
1989,CT,F,17679,1436,19115,7.512424797279624
1989,CT,M,13355,8808,22163,39.741912196002346
1989,DC,F,1403,134,1537,8.718282368249836
1989,DC,M,9863,3270,13133,24.899109114444528
1989,DE,F,3382,306,3688,8.297180043383948
1989,DE,M,2747,1948,4695,41.49094781682641
1989,FL,F,72210,4796,77006,6.228086123159234
1989,FL,M,60723,28596,89319,32.01558459006482
1989,GA,F,38608,3236,41844,7.733486282382182
1989,GA,M,33631,15840,49471,32.01875846455499
1989,HI,F,4731,318,5049,6.2982768865121805
1989,HI,M,4593,2335,6928,33.70381062355658
1989,IA,F,14676,1181,15857,7.447814845178785
1989,IA,M,11450,6795,18245,37.243080295971495
1989,ID,F,4735,398,5133,7.7537502435223065
1989,ID,M,4271,2423,6694,36.19659396474455
1989,IL,F,72057,5229,77286,6.765779054421241
1989,IL,M,57560,29287,86847,33.72252351837139
1989,IN,F,31525,2788,34313,8.125200361379068
1989,IN,M,25471,14177,39648,35.75716303470541
1989,KS,F,13018,1114,14132,7.882819133880554
1989,KS,M,11062,5998,17060,35.158264947245016
1989,KY,F,19445,1838,21283,8.636000563830287
1989,KY,M,15449,9024,24473,36.873288930658276
1989,LA,F,23997,1756,25753,6.818623073040034
1989,LA,M,22735,9188,31923,28.781756100617113
1989,MA,F,35616,2867,38483,7.45004287607515
1989,MA,M,26331,17457,43788,39.86708687311592
1989,MD,F,25629,2079,27708,7.503248159376354
1989,MD,M,20875,11226,32101,34.97087318152082
1989,ME,F,5780,516,6296,8.195679796696314
1989,ME,M,4420,3216,7636,42.11629125196438
1989,MI,F,56215,4218,60433,6.979630334419936
1989,MI,M,45496,23988,69484,34.523055667491796
1989,MN,F,25979,2312,28291,8.172210243540349
1989,MN,M,18756,12823,31579,40.60609898983502
1989,MO,F,29986,2541,32527,7.811971592830572
1989,MO,M,24427,13332,37759,35.3081384570566
1989,MS,F,12701,998,13699,7.285203299510913
1989,MS,M,12124,5044,17168,29.380242311276795
1989,MT,F,3314,273,3587,7.610816838583774
1989,MT,M,2857,1757,4614,38.079757260511485
1989,NC,F,37456,3229,40685,7.936585965343493
1989,NC,M,30627,15643,46270,33.80808299113897
1989,ND,F,3472,276,3748,7.363927427961579
1989,ND,M,2796,1842,4638,39.715394566623544
1989,NE,F,8436,683,9119,7.489856343897356
1989,NE,M,6694,4308,11002,39.15651699690965
1989,NH,F,6289,601,6890,8.72278664731495
1989,NH,M,4838,3160,7998,39.509877469367346
1989,NJ,F,45259,2734,47993,5.696664096847457
1989,NJ,M,35070,20027,55097,36.34862152204294
1989,NM,F,8469,677,9146,7.402143013339164
1989,NM,M,7550,4072,11622,35.03699879538806
1989,NV,F,5707,432,6139,7.0369767063039586
1989,NV,M,5133,2849,7982,35.69280881984465
1989,NY,F,111360,7343,118703,6.186027311862379
1989,NY,M,87611,47263,134874,35.0423358097187
1989,OH,F,64438,5401,69839,7.733501338793511
1989,OH,M,49987,28148,78135,36.024828821910795
1989,OK,F,15821,1402,17223,8.14027753585322
1989,OK,M,13849,6708,20557,32.63122050882911
1989,OR,F,14779,1286,16065,8.004979769685653
1989,OR,M,12441,7035,19476,36.12138016019716
1989,PA,F,66795,5030,71825,7.003132613992342
1989,PA,M,51068,30395,81463,37.31141745332236
1989,RI,F,5004,345,5349,6.449803701626472
1989,RI,M,3827,2724,6551,41.581437948404826
1989,SC,F,18263,1533,19796,7.743988684582743
1989,SC,M,16065,7524,23589,31.896222815719188
1989,SD,F,3378,292,3670,7.956403269754768
1989,SD,M,2863,1822,4685,38.890074706510134
1989,TN,F,27199,2576,29775,8.651553316540722
1989,TN,M,22766,11899,34665,34.325688735035335
1989,TX,F,123581,9782,133363,7.334867991871809
1989,TX,M,102012,46084,148096,31.11765341400173
1989,UT,F,12552,895,13447,6.6557596489923405
1989,UT,M,11251,5301,16552,32.026341227646206
1989,VA,F,34075,3018,37093,8.136306041571185
1989,VA,M,27182,14684,41866,35.07380690775331
1989,VT,F,2474,269,2743,9.80678089682829
1989,VT,M,2026,1409,3435,41.01892285298399
1989,WA,F,27149,2342,29491,7.941405852633007
1989,WA,M,22294,11749,34043,34.51223452692184
1989,WI,F,27030,2253,29283,7.693883823378752
1989,WI,M,20511,12620,33131,38.09121366695844
1989,WV,F,8070,725,8795,8.24332006822058
1989,WV,M,6377,3889,10266,37.88233002142996
1989,WY,F,1659,147,1806,8.13953488372093
1989,WY,M,1440,987,2427,40.66749072929542
1990,AK,F,3059,359,3418,10.503218256290229
1990,AK,M,2698,1719,4417,38.91781752320579
1990,AL,F,20446,2027,22473,9.019712543941619
1990,AL,M,18239,8877,27116,32.737129370113585
1990,AR,F,11494,1133,12627,8.972835986378396
1990,AR,M,10569,4916,15485,31.74685179205683
1990,AZ,F,24410,1828,26238,6.966994435551491
1990,AZ,M,20564,10197,30761,33.14911738890153
1990,CA,F,245558,16674,262232,6.358491717258001
1990,CA,M,203809,86444,290253,29.78229337853528
1990,CO,F,19054,1696,20750,8.173493975903614
1990,CO,M,15904,8536,24440,34.92635024549918
1990,CT,F,17636,1439,19075,7.5439056356487555
1990,CT,M,13939,8626,22565,38.22734323066696
1990,DC,F,4216,431,4647,9.274800946847428
1990,DC,M,6593,2698,9291,29.038854805725972
1990,DE,F,3399,308,3707,8.30860534124629
1990,DE,M,2928,1991,4919,40.475706444399265
1990,FL,F,74028,5064,79092,6.402670307995752
1990,FL,M,62871,28803,91674,31.41894103017213
1990,GA,F,39102,3539,42641,8.299523932365565
1990,GA,M,34504,15665,50169,31.224461320735912
1990,HI,F,5052,399,5451,7.3197578425976895
1990,HI,M,4805,2421,7226,33.50401328535843
1990,IA,F,14660,1315,15975,8.231611893583725
1990,IA,M,11864,6671,18535,35.991367682762345
1990,ID,F,4899,457,5356,8.532486930545183
1990,ID,M,4410,2417,6827,35.40354474879157
1990,IL,F,72923,5554,78477,7.077232819807078
1990,IL,M,59681,29549,89230,33.115544099518104
1990,IN,F,32283,2881,35164,8.193038334660448
1990,IN,M,26358,14196,40554,35.005178280810775
1990,KS,F,12729,1224,13953,8.772307030746077
1990,KS,M,11081,5829,16910,34.47072738024837
1990,KY,F,19370,1865,21235,8.782670120084765
1990,KY,M,15755,9053,24808,36.49226056110932
1990,LA,F,23532,1852,25384,7.295934446895683
1990,LA,M,22358,8900,31258,28.472710985987586
1990,MA,F,35920,2812,38732,7.260146648765878
1990,MA,M,26881,17162,44043,38.96646459142202
1990,MD,F,26061,2295,28356,8.093525179856115
1990,MD,M,21840,11360,33200,34.21686746987952
1990,ME,F,5750,580,6330,9.162717219589258
1990,ME,M,4488,3050,7538,40.46166091801539
1990,MI,F,58089,4365,62454,6.989144009991353
1990,MI,M,46749,24306,71055,34.20730420097108
1990,MN,F,25492,2434,27926,8.715892000286471
1990,MN,M,19334,12425,31759,39.12276834912938
1990,MO,F,30125,2713,32838,8.26176990072477
1990,MO,M,24965,13015,37980,34.26803580832017
1990,MS,F,12694,1082,13776,7.85423925667828
1990,MS,M,12031,5121,17152,29.85657649253731
1990,MT,F,2996,323,3319,9.731846941849955
1990,MT,M,2995,1694,4689,36.12710599274899
1990,NC,F,37411,3436,40847,8.411878473327295
1990,NC,M,31696,15843,47539,33.3263215465197
1990,ND,F,3293,261,3554,7.343837929093978
1990,ND,M,2677,1630,4307,37.845368005572325
1990,NE,F,8448,736,9184,8.013937282229964
1990,NE,M,6916,4011,10927,36.70723894939141
1990,NH,F,6016,615,6631,9.274619212788417
1990,NH,M,4705,3135,7840,39.98724489795919
1990,NJ,F,45102,2845,47947,5.933635055373641
1990,NJ,M,35263,19490,54753,35.596223038007054
1990,NM,F,8632,648,9280,6.982758620689655
1990,NM,M,7375,4035,11410,35.363716038562664
1990,NV,F,6431,461,6892,6.688914683691236
1990,NV,M,5730,2886,8616,33.4958217270195
1990,NY,F,114279,7687,121966,6.302576127773314
1990,NY,M,91065,47714,138779,34.38128247069081
1990,OH,F,65260,5603,70863,7.906806090625573
1990,OH,M,51789,28069,79858,35.14863883393022
1990,OK,F,15968,1479,17447,8.47710208058692
1990,OK,M,14100,6440,20540,31.353456669912365
1990,OR,F,15370,1410,16780,8.402860548271752
1990,OR,M,13159,7079,20238,34.978752841189845
1990,PA,F,67368,5198,72566,7.163134250199818
1990,PA,M,52028,30240,82268,36.75791316186123
1990,RI,F,5108,411,5519,7.447001268345716
1990,RI,M,3903,2758,6661,41.405194415252964
1990,SC,F,18415,1616,20031,8.067495382157656
1990,SC,M,16574,7709,24283,31.74648931351151
1990,SD,F,3371,298,3669,8.122104115562824
1990,SD,M,2835,1736,4571,37.97856049004594
1990,TN,F,27346,2833,30179,9.387322310215714
1990,TN,M,23472,12153,35625,34.113684210526316
1990,TX,F,127151,10396,137547,7.558143761768704
1990,TX,M,106145,47062,153207,30.71791758862193
1990,UT,F,12632,917,13549,6.7680271606760645
1990,UT,M,11365,5278,16643,31.713032506158743
1990,VA,F,34699,3075,37774,8.140519934346376
1990,VA,M,28411,14921,43332,34.43413643496723
1990,VT,F,2379,286,2665,10.731707317073171
1990,VT,M,1977,1382,3359,41.143197380172666
1990,WA,F,28363,2537,30900,8.210355987055017
1990,WA,M,23712,12136,35848,33.85405043517072
1990,WI,F,27052,2270,29322,7.741627446968147
1990,WI,M,20844,12481,33325,37.45236309077269
1990,WV,F,8046,738,8784,8.401639344262295
1990,WV,M,6655,3868,10523,36.75757863727074
1990,WY,F,1538,147,1685,8.724035608308606
1990,WY,M,1460,942,2402,39.217318900915906
1991,AK,F,3011,334,3345,9.985052316890881
1991,AK,M,2801,1598,4399,36.326437826778815
1991,AL,F,20048,2014,22062,9.12881878342852
1991,AL,M,17921,8479,26400,32.11742424242424
1991,AR,F,10920,1119,12039,9.294791926239721
1991,AR,M,10230,4741,14971,31.667891256429098
1991,AZ,F,23891,1902,25793,7.3740937463652925
1991,AZ,M,20773,9635,30408,31.685740594580373
1991,CA,F,244254,17124,261378,6.551431260473338
1991,CA,M,203617,84307,287924,29.280990817021156
1991,CO,F,18942,1874,20816,9.002690238278248
1991,CO,M,15910,8352,24262,34.42420245651636
1991,CT,F,17040,1493,18533,8.055900285976367
1991,CT,M,13503,8081,21584,37.43977020014826
1991,DC,F,5319,521,5840,8.92123287671233
1991,DC,M,5418,2493,7911,31.513083048919228
1991,DE,F,3405,328,3733,8.786498794535227
1991,DE,M,2880,1803,4683,38.50096092248559
1991,FL,F,71209,5120,76329,6.707804373174023
1991,FL,M,61439,27592,89031,30.991452415450798
1991,GA,F,38302,3550,41852,8.482270859218199
1991,GA,M,33634,15008,48642,30.853994490358126
1991,HI,F,4651,394,5045,7.809712586719525
1991,HI,M,4560,2415,6975,34.623655913978496
1991,IA,F,14136,1364,15500,8.799999999999999
1991,IA,M,11676,6284,17960,34.98886414253898
1991,ID,F,4984,431,5415,7.959372114496769
1991,ID,M,4573,2335,6908,33.80138969310944
1991,IL,F,71608,5905,77513,7.618076967734444
1991,IL,M,58882,28635,87517,32.71935738199436
1991,IN,F,31806,3011,34817,8.648074216618319
1991,IN,M,26257,13720,39977,34.319733846962
1991,KS,F,12175,1189,13364,8.897036815324753
1991,KS,M,10689,5397,16086,33.5509138381201
1991,KY,F,19491,1974,21465,9.196366177498252
1991,KY,M,15984,8791,24775,35.48335015136226
1991,LA,F,23161,1887,25048,7.533535611625679
1991,LA,M,22289,8704,30993,28.08376084922402
1991,MA,F,33394,2907,36301,8.00804385554117
1991,MA,M,25601,15959,41560,38.39990375360924
1991,MD,F,25181,2425,27606,8.784322248786495
1991,MD,M,21620,11091,32711,33.906025496010514
1991,ME,F,5481,526,6007,8.756450807391376
1991,ME,M,4549,2816,7365,38.23489477257298
1991,MI,F,55797,4588,60385,7.597913389086694
1991,MI,M,45773,22957,68730,33.401716863087444
1991,MN,F,24956,2512,27468,9.145187126838502
1991,MN,M,19114,11862,30976,38.2941632231405
1991,MO,F,29618,2853,32471,8.786301622986665
1991,MO,M,24725,12544,37269,33.6579999463361
1991,MS,F,12361,1097,13458,8.151285480754941
1991,MS,M,11791,4964,16755,29.62697702178454
1991,MT,F,3113,353,3466,10.184650894402768
1991,MT,M,2851,1563,4414,35.4100589034889
1991,NC,F,36311,3544,39855,8.892234349516999
1991,NC,M,30805,15273,46078,33.1459698771648
1991,ND,F,3127,246,3373,7.293210791580195
1991,ND,M,2680,1558,4238,36.7626238791883
1991,NE,F,8075,806,8881,9.075554554667267
1991,NE,M,6800,3799,10599,35.84300405698651
1991,NH,F,5479,583,6062,9.617288023754536
1991,NH,M,4361,2801,7162,39.10918737782742
1991,NJ,F,43745,2928,46673,6.27343431962805
1991,NJ,M,35079,18355,53434,34.350787887861664
1991,NM,F,8656,721,9377,7.689026341047243
1991,NM,M,7457,4031,11488,35.08878830083565
1991,NV,F,6552,557,7109,7.835138556759038
1991,NV,M,6134,3046,9180,33.18082788671024
1991,NY,F,111094,7864,118958,6.610736562484239
1991,NY,M,89143,45295,134438,33.69211086151237
1991,OH,F,64239,5917,70156,8.434061234962083
1991,OH,M,52380,27312,79692,34.27194699593435
1991,OK,F,15556,1502,17058,8.80525266737015
1991,OK,M,14209,6471,20680,31.29110251450677
1991,OR,F,15313,1539,16852,9.132447187277474
1991,OR,M,12885,6805,19690,34.56069070594211
1991,PA,F,65495,5502,70997,7.749623223516487
1991,PA,M,51585,28694,80279,35.74284682170929
1991,RI,F,4882,383,5265,7.274453941120608
1991,RI,M,3924,2621,6545,40.04583651642476
1991,SC,F,17641,1630,19271,8.458305225468319
1991,SC,M,16076,7174,23250,30.855913978494627
1991,SD,F,3290,287,3577,8.023483365949119
1991,SD,M,2872,1678,4550,36.87912087912088
1991,TN,F,27580,2831,30411,9.309131564236624
1991,TN,M,23599,11767,35366,33.27206921902392
1991,TX,F,125939,10436,136375,7.652428964252979
1991,TX,M,107172,46096,153268,30.075423441292376
1991,UT,F,12299,989,13288,7.442805538832029
1991,UT,M,11526,5016,16542,30.322814653608994
1991,VA,F,33743,3145,36888,8.525807850791585
1991,VA,M,27776,14332,42108,34.03628764130332
1991,VT,F,2235,263,2498,10.528422738190553
1991,VT,M,1949,1209,3158,38.283723875870805
1991,WA,F,28354,2587,30941,8.361074302705148
1991,WA,M,24135,11881,36016,32.98811639271435
1991,WI,F,26070,2372,28442,8.33977919977498
1991,WI,M,20987,11802,32789,35.99377840129311
1991,WV,F,8056,709,8765,8.088990302338846
1991,WV,M,6561,3775,10336,36.522832817337466
1991,WY,F,1537,158,1695,9.321533923303834
1991,WY,M,1477,873,2350,37.148936170212764
1992,AK,F,2936,303,3239,9.354739117011423
1992,AK,M,2701,1600,4301,37.2006510113927
1992,AL,F,19347,2030,21377,9.496187491228891
1992,AL,M,18306,8061,26367,30.572306291955854
1992,AR,F,10727,1129,11856,9.522604588394062
1992,AR,M,9950,4382,14332,30.574937203460788
1992,AZ,F,24320,1861,26181,7.1082082426186926
1992,AZ,M,21439,9796,31235,31.362253881863296
1992,CA,F,240210,16458,256668,6.4121744822104825
1992,CA,M,202388,81990,284378,28.831344196808473
1992,CO,F,19293,1832,21125,8.672189349112426
1992,CO,M,16591,8099,24690,32.80275415147833
1992,CT,F,16412,1445,17857,8.092064736517893
1992,CT,M,13363,7571,20934,36.16604566733543
1992,DC,F,4836,431,5267,8.183026390734764
1992,DC,M,5199,2296,7495,30.633755837224818
1992,DE,F,3281,287,3568,8.04372197309417
1992,DE,M,2742,1665,4407,37.78080326752893
1992,FL,F,70079,4957,75036,6.606162375393144
1992,FL,M,61660,25826,87486,29.520151795715886
1992,GA,F,37769,3514,41283,8.511978296150959
1992,GA,M,34376,14392,48768,29.511154855643046
1992,HI,F,4440,358,4798,7.461442267611505
1992,HI,M,4576,2287,6863,33.323619408421976
1992,IA,F,13979,1294,15273,8.472467753552019
1992,IA,M,11719,5851,17570,33.30108138873079
1992,ID,F,5027,416,5443,7.6428440198419985
1992,ID,M,4882,2283,7165,31.86322400558269
1992,IL,F,69616,5637,75253,7.49073126652758
1992,IL,M,59280,26965,86245,31.265580613368893
1992,IN,F,30354,2875,33229,8.652081013572483
1992,IN,M,26285,12947,39232,33.00112153344209
1992,KS,F,12148,1184,13332,8.88088808880888
1992,KS,M,10847,5129,15976,32.10440660991487
1992,KY,F,19019,1950,20969,9.299442033477991
1992,KY,M,16083,8216,24299,33.812091032552786
1992,LA,F,21936,1757,23693,7.4156923985987415
1992,LA,M,22561,7944,30505,26.04163251925914
1992,MA,F,33009,2867,35876,7.991414873453005
1992,MA,M,25594,15337,40931,37.470376975886246
1992,MD,F,24532,2335,26867,8.690959169241076
1992,MD,M,21556,10335,31891,32.40726223699477
1992,ME,F,5138,577,5715,10.096237970253718
1992,ME,M,4446,2513,6959,36.11151027446472
1992,MI,F,52654,4403,57057,7.716844558949822
1992,MI,M,45025,20910,65935,31.7130507317813
1992,MN,F,24002,2368,26370,8.979901403109594
1992,MN,M,19321,11035,30356,36.35195677954935
1992,MO,F,28231,2679,30910,8.667098026528631
1992,MO,M,24721,11580,36301,31.89994765984408
1992,MS,F,11770,1111,12881,8.625106746370625
1992,MS,M,11728,4663,16391,28.44853883228601
1992,MT,F,3049,304,3353,9.066507605129734
1992,MT,M,2907,1491,4398,33.90177353342428
1992,NC,F,36369,3472,39841,8.71464069676966
1992,NC,M,31661,14785,46446,31.832665891573008
1992,ND,F,3098,226,3324,6.799037304452467
1992,ND,M,2735,1417,4152,34.128131021194605
1992,NE,F,7734,764,8498,8.990350670746059
1992,NE,M,6770,3566,10336,34.500773993808046
1992,NH,F,5268,584,5852,9.979494190020507
1992,NH,M,4198,2606,6804,38.30099941211053
1992,NJ,F,42697,2842,45539,6.2408045850809195
1992,NJ,M,34828,17863,52691,33.90142529084663
1992,NM,F,8601,666,9267,7.186791842020071
1992,NM,M,7778,3820,11598,32.93671322641835
1992,NV,F,6753,515,7268,7.085855806274079
1992,NV,M,6243,2805,9048,31.00132625994695
1992,NY,F,108222,7821,116043,6.739743026291977
1992,NY,M,88696,43364,132060,32.8365894290474
1992,OH,F,62340,5557,67897,8.184455866974977
1992,OH,M,51572,25474,77046,33.06336474314046
1992,OK,F,15802,1392,17194,8.09584738862394
1992,OK,M,14463,5876,20339,28.890309258075618
1992,OR,F,14748,1502,16250,9.243076923076924
1992,OR,M,13067,6387,19454,32.831294335355196
1992,PA,F,63184,5253,68437,7.675672516328887
1992,PA,M,51049,26851,77900,34.46854942233633
1992,RI,F,4796,432,5228,8.26319816373374
1992,RI,M,3933,2483,6416,38.7001246882793
1992,SC,F,17228,1652,18880,8.75
1992,SC,M,15719,6853,22572,30.360623781676416
1992,SD,F,3371,299,3670,8.147138964577657
1992,SD,M,3012,1470,4482,32.79785809906292
1992,TN,F,26898,2845,29743,9.565275863228322
1992,TN,M,23903,11281,35184,32.062869486130054
1992,TX,F,127085,10452,137537,7.599409613413117
1992,TX,M,108356,44932,153288,29.312144460101248
1992,UT,F,12747,1061,13808,7.683951332560834
1992,UT,M,11689,4992,16681,29.926263413464422
1992,VA,F,33332,3161,36493,8.661935165648206
1992,VA,M,28244,13830,42074,32.87065646242335
1992,VT,F,2142,240,2382,10.075566750629724
1992,VT,M,1872,1147,3019,37.99271281881418
1992,WA,F,28170,2605,30775,8.464662875710804
1992,WA,M,24812,11510,36322,31.688783657287594
1992,WI,F,25392,2265,27657,8.18960841739885
1992,WI,M,20949,10954,31903,34.33532896592797
1992,WV,F,7632,730,8362,8.729968906960057
1992,WV,M,6784,3494,10278,33.99494064993189
1992,WY,F,1475,122,1597,7.639323731997496
1992,WY,M,1418,867,2285,37.943107221006564
1993,AK,F,2700,323,3023,10.684750248097915
1993,AK,M,2514,1448,3962,36.547198384654216
1993,AL,F,19298,2046,21344,9.585832083958021
1993,AL,M,17886,8042,25928,31.01666152422092
1993,AR,F,10485,1105,11590,9.534081104400345
1993,AR,M,9974,4302,14276,30.13449145418885
1993,AZ,F,24429,1843,26272,7.015073081607795
1993,AZ,M,21251,9513,30764,30.922506826160443
1993,CA,F,233448,16015,249463,6.419789708293415
1993,CA,M,196654,78853,275507,28.62105137074557
1993,CO,F,18485,1778,20263,8.7746138281597
1993,CO,M,16422,7931,24353,32.5668295487209
1993,CT,F,16334,1404,17738,7.915210283008231
1993,CT,M,12958,7393,20351,36.32745319640313
1993,DC,F,4540,489,5029,9.723603102008353
1993,DC,M,4765,2112,6877,30.711065871746403
1993,DE,F,3029,308,3337,9.229847168115073
1993,DE,M,2601,1627,4228,38.48155156102176
1993,FL,F,69375,5070,74445,6.8103969373362885
1993,FL,M,61909,25909,87818,29.503063153339866
1993,GA,F,36841,3617,40458,8.940135449107716
1993,GA,M,33852,14284,48136,29.67425627389064
1993,HI,F,4410,321,4731,6.7850348763474955
1993,HI,M,4342,2197,6539,33.59840954274354
1993,IA,F,13566,1314,14880,8.830645161290322
1993,IA,M,11882,5667,17549,32.292438315573534
1993,ID,F,5053,466,5519,8.443558615691249
1993,ID,M,4886,2208,7094,31.12489427685368
1993,IL,F,69600,5564,75164,7.402479910595498
1993,IL,M,59330,26282,85612,30.698967434471804
1993,IN,F,30269,2874,33143,8.671514346920919
1993,IN,M,26093,12622,38715,32.60235051013819
1993,KS,F,11762,1148,12910,8.892331525948876
1993,KS,M,10784,4925,15709,31.35145458017697
1993,KY,F,18045,1906,19951,9.55340584431858
1993,KY,M,15915,8017,23932,33.49908072873141
1993,LA,F,21264,1841,23105,7.967972300367886
1993,LA,M,21717,7527,29244,25.738613048830526
1993,MA,F,31388,2864,34252,8.36155552960411
1993,MA,M,25108,14433,39541,36.50135302597304
1993,MD,F,23343,2337,25680,9.100467289719626
1993,MD,M,20757,9686,30443,31.816838025161776
1993,ME,F,4766,495,5261,9.408857631628969
1993,ME,M,4239,2403,6642,36.17886178861789
1993,MI,F,51074,4309,55383,7.780365816225196
1993,MI,M,43716,20067,63783,31.461361177743285
1993,MN,F,23445,2433,25878,9.40180848597264
1993,MN,M,19084,10720,29804,35.968326399141056
1993,MO,F,27783,2725,30508,8.932083387963813
1993,MO,M,24221,11485,35706,32.16546238727385
1993,MS,F,11324,1081,12405,8.71422813381701
1993,MS,M,11429,4411,15840,27.84722222222222
1993,MT,F,2918,316,3234,9.771181199752627
1993,MT,M,2994,1444,4438,32.53717890941866
1993,NC,F,34831,3546,38377,9.23990932068687
1993,NC,M,30600,14288,44888,31.830333273926215
1993,ND,F,2948,261,3209,8.133374883141165
1993,ND,M,2753,1357,4110,33.017031630170315
1993,NE,F,7738,753,8491,8.868213402426099
1993,NE,M,6629,3281,9910,33.1079717457114
1993,NH,F,4938,546,5484,9.956236323851202
1993,NH,M,4287,2453,6740,36.394658753709194
1993,NJ,F,41648,2834,44482,6.371116406636393
1993,NJ,M,33882,17123,51005,33.571218507989414
1993,NM,F,8583,673,9256,7.27095937770095
1993,NM,M,7571,3871,11442,33.831497989861916
1993,NV,F,6524,501,7025,7.131672597864769
1993,NV,M,6317,2819,9136,30.85595446584939
1993,NY,F,105394,7639,113033,6.758203356541895
1993,NY,M,87510,41388,128898,32.109109528464366
1993,OH,F,60396,5604,66000,8.49090909090909
1993,OH,M,50600,24230,74830,32.38006147267139
1993,OK,F,15038,1401,16439,8.522416205365289
1993,OK,M,13738,5776,19514,29.599262068258685
1993,OR,F,14572,1391,15963,8.713900895821586
1993,OR,M,12967,6284,19251,32.6424601319412
1993,PA,F,60818,5374,66192,8.118805897993715
1993,PA,M,50106,25707,75813,33.90843259071663
1993,RI,F,4568,419,4987,8.401844796470824
1993,RI,M,3847,2284,6131,37.25330288696787
1993,SC,F,15977,1607,17584,9.138989990900818
1993,SC,M,15126,6468,21594,29.952764656849123
1993,SD,F,3074,284,3358,8.457415128052412
1993,SD,M,2898,1495,4393,34.031413612565444
1993,TN,F,26373,2843,29216,9.730969331872947
1993,TN,M,23270,11201,34471,32.49398044733254
1993,TX,F,126948,10057,137005,7.340608007007043
1993,TX,M,108774,44309,153083,28.944428839257135
1993,UT,F,12524,999,13523,7.387414035347187
1993,UT,M,11936,4941,16877,29.276530189014636
1993,VA,F,32039,3192,35231,9.060202662427976
1993,VA,M,27979,13107,41086,31.901377598208636
1993,VT,F,2020,248,2268,10.934744268077601
1993,VT,M,1846,1065,2911,36.58536585365854
1993,WA,F,27278,2440,29718,8.21051214752002
1993,WA,M,23778,10781,34559,31.195925808038428
1993,WI,F,24768,2295,27063,8.480212836714333
1993,WI,M,20722,10443,31165,33.508743783090004
1993,WV,F,7732,691,8423,8.203727887925917
1993,WV,M,6516,3432,9948,34.499396863691196
1993,WY,F,1426,116,1542,7.522697795071336
1993,WY,M,1449,736,2185,33.68421052631579
1994,AK,F,2493,283,2776,10.194524495677234
1994,AK,M,2411,1351,3762,35.911749069643804
1994,AL,F,18804,2194,20998,10.448614153728926
1994,AL,M,17388,7799,25187,30.964386389804265
1994,AR,F,10197,1208,11405,10.591845681718544
1994,AR,M,9786,4095,13881,29.500756429652043
1994,AZ,F,25146,1884,27030,6.9700332963374025
1994,AZ,M,22080,9876,31956,30.90499436725497
1994,CA,F,226713,15723,242436,6.485422956986586
1994,CA,M,190625,76435,267060,28.620909158990486
1994,CO,F,18459,1766,20225,8.73176761433869
1994,CO,M,16524,7803,24327,32.075471698113205
1994,CT,F,15558,1509,17067,8.841624187027596
1994,CT,M,12714,7072,19786,35.74244415243101
1994,DC,F,4149,487,4636,10.50474547023296
1994,DC,M,4307,2005,6312,31.76489226869455
1994,DE,F,2999,354,3353,10.55770951386818
1994,DE,M,2618,1553,4171,37.23327739151283
1994,FL,F,69208,5295,74503,7.107096358535898
1994,FL,M,60638,24849,85487,29.067577526407522
1994,GA,F,36879,3862,40741,9.479394222036769
1994,GA,M,33899,14195,48094,29.51511623071485
1994,HI,F,4315,355,4670,7.601713062098502
1994,HI,M,4262,2150,6412,33.5308796007486
1994,IA,F,12998,1269,14267,8.894651994112287
1994,IA,M,11624,5367,16991,31.58731092931552
1994,ID,F,4949,427,5376,7.942708333333333
1994,ID,M,4797,2162,6959,31.06768213823825
1994,IL,F,68579,5642,74221,7.601622182401208
1994,IL,M,58566,25955,84521,30.708344671738384
1994,IN,F,29820,2957,32777,9.021570003356013
1994,IN,M,25698,11999,37697,31.830119107621297
1994,KS,F,11653,1223,12876,9.498291394843118
1994,KS,M,10658,4840,15498,31.22983610788489
1994,KY,F,18104,1880,19984,9.407526020816654
1994,KY,M,15743,7733,23476,32.94002385414892
1994,LA,F,20568,1843,22411,8.223640176698943
1994,LA,M,20795,7326,28121,26.051705131396464
1994,MA,F,30888,2923,33811,8.645115494957263
1994,MA,M,24486,14181,38667,36.674683838932424
1994,MD,F,22910,2344,25254,9.281697948839787
1994,MD,M,20252,9851,30103,32.724313191376275
1994,ME,F,4613,500,5113,9.778994719342851
1994,ME,M,3988,2248,6236,36.04874919820398
1994,MI,F,49791,4409,54200,8.13468634686347
1994,MI,M,43373,19124,62497,30.599868793702097
1994,MN,F,23165,2445,25610,9.547051932838734
1994,MN,M,18699,10464,29163,35.881082193190004
1994,MO,F,26946,2713,29659,9.147307731211436
1994,MO,M,23858,10883,34741,31.32609884574422
1994,MS,F,11050,1130,12180,9.277504105090312
1994,MS,M,11170,4498,15668,28.708195047230024
1994,MT,F,2844,293,3137,9.340133885878227
1994,MT,M,2858,1408,4266,33.005157055789965
1994,NC,F,34451,3696,38147,9.68883529504286
1994,NC,M,30629,14146,44775,31.59352317141262
1994,ND,F,2777,261,3038,8.591178406846609
1994,ND,M,2606,1355,3961,34.2085331986872
1994,NE,F,7351,744,8095,9.190858554663372
1994,NE,M,6684,3303,9987,33.07299489336137
1994,NH,F,4714,543,5257,10.329085029484498
1994,NH,M,4142,2386,6528,36.55024509803921
1994,NJ,F,41090,2920,44010,6.634855714610316
1994,NJ,M,33959,16611,50570,32.847538066047065
1994,NM,F,8141,683,8824,7.740253853127833
1994,NM,M,7407,3747,11154,33.5933297471759
1994,NV,F,7182,589,7771,7.579462102689487
1994,NV,M,6600,2976,9576,31.07769423558897
1994,NY,F,103444,7715,111159,6.9405086407758265
1994,NY,M,85927,39967,125894,31.74654868381337
1994,OH,F,58802,5802,64604,8.980868057705406
1994,OH,M,49959,23589,73548,32.07293196279981
1994,OK,F,14799,1397,16196,8.625586564583848
1994,OK,M,13696,5598,19294,29.014201306105527
1994,OR,F,14589,1433,16022,8.943952065909375
1994,OR,M,13140,6035,19175,31.473272490221643
1994,PA,F,59505,5388,64893,8.302898617724562
1994,PA,M,48903,24523,73426,33.398251300629205
1994,RI,F,4327,426,4753,8.96276036187671
1994,RI,M,3648,2290,5938,38.56517345907713
1994,SC,F,14958,1613,16571,9.7338724277352
1994,SC,M,14350,6328,20678,30.60257278266757
1994,SD,F,3006,278,3284,8.465286236297198
1994,SD,M,2949,1438,4387,32.778664235240484
1994,TN,F,26301,2901,29202,9.93425107869324
1994,TN,M,23682,10961,34643,31.63986952631123
1994,TX,F,125793,10165,135958,7.476573647744155
1994,TX,M,108916,44294,153210,28.910645519221983
1994,UT,F,12937,964,13901,6.934752895475145
1994,UT,M,12468,4949,17417,28.41476718148935
1994,VA,F,31913,3336,35249,9.464098272291412
1994,VA,M,27730,13286,41016,32.3922371757363
1994,VT,F,2060,224,2284,9.807355516637479
1994,VT,M,1837,998,2835,35.20282186948854
1994,WA,F,26341,2546,28887,8.813653200401566
1994,WA,M,23126,10643,33769,31.517071870650597
1994,WI,F,23846,2425,26271,9.23071066955959
1994,WI,M,20321,9923,30244,32.80981351673059
1994,WV,F,7247,668,7915,8.439671509791536
1994,WV,M,6441,3437,9878,34.79449281231018
1994,WY,F,1359,121,1480,8.175675675675675
1994,WY,M,1362,715,2077,34.424650938854114
1995,AK,F,2279,342,2621,13.048454788248758
1995,AK,M,2295,1311,3606,36.356073211314474
1995,AL,F,18495,2250,20745,10.84598698481562
1995,AL,M,17187,7548,24735,30.515463917525775
1995,AR,F,10392,1207,11599,10.40606948874903
1995,AR,M,9866,4036,13902,29.031793986476767
1995,AZ,F,25277,1997,27274,7.321991640390115
1995,AZ,M,22749,9783,32532,30.071929177425304
1995,CA,F,219178,15370,234548,6.553029657042482
1995,CA,M,184927,75608,260535,29.020285182413115
1995,CO,F,18352,1914,20266,9.444389618079542
1995,CO,M,16745,7759,24504,31.664218086842965
1995,CT,F,14916,1516,16432,9.225900681596883
1995,CT,M,12388,6981,19369,36.0421291754866
1995,DC,F,3592,436,4028,10.824230387288978
1995,DC,M,3699,1845,5544,33.27922077922078
1995,DE,F,2860,328,3188,10.28858218318695
1995,DE,M,2531,1490,4021,37.05545884108431
1995,FL,F,67404,5440,72844,7.468013837790346
1995,FL,M,60268,24743,85011,29.105645151803884
1995,GA,F,36860,4066,40926,9.935004642525534
1995,GA,M,34193,14310,48503,29.50332969094695
1995,HI,F,4038,359,4397,8.164657721173528
1995,HI,M,3949,2018,5967,33.81933970169264
1995,IA,F,12822,1360,14182,9.589620645889156
1995,IA,M,11278,5129,16407,31.261047114036693
1995,ID,F,5132,455,5587,8.143905494898872
1995,ID,M,4984,2243,7227,31.036391310363914
1995,IL,F,66499,6048,72547,8.33666450714709
1995,IL,M,56929,25866,82795,31.241016969623768
1995,IN,F,29616,3124,32740,9.54184483811851
1995,IN,M,26077,12134,38211,31.755253722749995
1995,KS,F,11546,1243,12789,9.719290014856517
1995,KS,M,10580,4668,15248,30.613850996852047
1995,KY,F,17606,2027,19633,10.32445372586971
1995,KY,M,15693,7543,23236,32.462558099500775
1995,LA,F,20116,1850,21966,8.42210689247018
1995,LA,M,20101,7141,27242,26.213200205564934
1995,MA,F,29886,3099,32985,9.395179627103229
1995,MA,M,23740,14023,37763,37.134231920133466
1995,MD,F,22225,2425,24650,9.837728194726166
1995,MD,M,19992,9581,29573,32.39779528624083
1995,ME,F,4340,494,4834,10.219280099296649
1995,ME,M,3747,2170,5917,36.67399019773534
1995,MI,F,47960,4630,52590,8.803955124548393
1995,MI,M,41652,19019,60671,31.34776087422327
1995,MN,F,22452,2519,24971,10.087701734011453
1995,MN,M,18481,9954,28435,35.006154387198876
1995,MO,F,26699,2875,29574,9.72137688510178
1995,MO,M,23576,10779,34355,31.375345655654197
1995,MS,F,10845,1244,12089,10.29034659607908
1995,MS,M,10744,4335,15079,28.74859075535513
1995,MT,F,2820,311,3131,9.932928776748643
1995,MT,M,2818,1291,4109,31.418836699926988
1995,NC,F,34368,3891,38259,10.170156041715675
1995,NC,M,30689,14213,44902,31.653378468665096
1995,ND,F,2936,305,3241,9.410675717371182
1995,ND,M,2573,1261,3834,32.88993218570683
1995,NE,F,7480,847,8327,10.171730515191546
1995,NE,M,6702,3367,10069,33.43926904359917
1995,NH,F,4487,555,5042,11.007536691788973
1995,NH,M,3957,2398,6355,37.73406766325728
1995,NJ,F,39649,3148,42797,7.355655770264271
1995,NJ,M,32914,16676,49590,33.6277475297439
1995,NM,F,7899,649,8548,7.592419279363593
1995,NM,M,7163,3600,10763,33.44792344141968
1995,NV,F,7448,588,8036,7.317073170731707
1995,NV,M,6930,3004,9934,30.239581236158646
1995,NY,F,99559,7898,107457,7.349916710870395
1995,NY,M,83429,39067,122496,31.892469958202717
1995,OH,F,57465,5926,63391,9.348330204603176
1995,OH,M,48783,23226,72009,32.25430154564013
1995,OK,F,14289,1383,15672,8.824655436447166
1995,OK,M,13924,5549,19473,28.49586607097006
1995,OR,F,14820,1418,16238,8.732602537258282
1995,OR,M,13229,6132,19361,31.671917772842313
1995,PA,F,56771,5542,62313,8.893810280358833
1995,PA,M,47261,23757,71018,33.4520825706159
1995,RI,F,4170,393,4563,8.61275476660092
1995,RI,M,3492,2124,5616,37.82051282051282
1995,SC,F,14682,1681,16363,10.273177290227952
1995,SC,M,14032,5934,19966,29.72052489231694
1995,SD,F,2987,286,3273,8.73816070882982
1995,SD,M,2834,1321,4155,31.793020457280385
1995,TN,F,26147,3145,29292,10.736719923528607
1995,TN,M,23642,10965,34607,31.684341318230413
1995,TX,F,126115,10325,136440,7.567428906479039
1995,TX,M,108802,44473,153275,29.015168814222804
1995,UT,F,13600,1195,14795,8.077053058465697
1995,UT,M,12530,5040,17570,28.68525896414343
1995,VA,F,30634,3440,34074,10.095674121030699
1995,VA,M,27001,12951,39952,32.41639967961554
1995,VT,F,1737,239,1976,12.09514170040486
1995,VT,M,1584,1004,2588,38.794435857805254
1995,WA,F,26029,2571,28600,8.98951048951049
1995,WA,M,22913,10352,33265,31.119795580940927
1995,WI,F,23460,2480,25940,9.56052428681573
1995,WI,M,19748,9737,29485,33.02357130744446
1995,WV,F,6991,742,7733,9.595241174188542
1995,WV,M,6280,3209,9489,33.81810517441248
1995,WY,F,1283,153,1436,10.654596100278551
1995,WY,M,1300,682,1982,34.409687184661955
1996,AK,F,2240,267,2507,10.65017949740726
1996,AK,M,2215,1356,3571,37.972556706804816
1996,AL,F,18292,2272,20564,11.048434156778837
1996,AL,M,17346,7797,25143,31.010619257845125
1996,AR,F,10505,1190,11695,10.175288584865328
1996,AR,M,10331,4239,14570,29.094028826355522
1996,AZ,F,26395,2050,28445,7.206890490420109
1996,AZ,M,23214,10393,33607,30.925104888862435
1996,CA,F,214475,15264,229739,6.6440613043497185
1996,CA,M,179528,74833,254361,29.419997562519413
1996,CO,F,18891,2083,20974,9.931343568227328
1996,CO,M,16959,8017,24976,32.09881486226778
1996,CT,F,14733,1568,16301,9.619041776578124
1996,CT,M,12316,6974,19290,36.15344738206325
1996,DC,F,3176,396,3572,11.08622620380739
1996,DC,M,3299,1728,5027,34.37437835687289
1996,DE,F,2820,343,3163,10.844135314574771
1996,DE,M,2398,1446,3844,37.61706555671176
1996,FL,F,67223,5496,72719,7.5578597065416195
1996,FL,M,60005,25120,85125,29.50954478707783
1996,GA,F,37133,4366,41499,10.520735439408178
1996,GA,M,34003,14618,48621,30.065198165401778
1996,HI,F,3840,348,4188,8.30945558739255
1996,HI,M,3689,2060,5749,35.8323186641155
1996,IA,F,12864,1423,14287,9.96010359067684
1996,IA,M,11496,5214,16710,31.202872531418315
1996,ID,F,5284,483,5767,8.375238425524536
1996,ID,M,5096,2243,7339,30.5627469682518
1996,IL,F,65524,5907,71431,8.269518836359564
1996,IL,M,56083,25192,81275,30.99600123039065
1996,IN,F,29653,3233,32886,9.830931095298912
1996,IN,M,25713,12105,37818,32.008567348881485
1996,KS,F,11149,1289,12438,10.36340247628236
1996,KS,M,10385,4718,15103,31.238826723167584
1996,KY,F,17590,2038,19628,10.383126146321581
1996,KY,M,15466,7776,23242,33.456673263918766
1996,LA,F,19661,1886,21547,8.75295864853576
1996,LA,M,19835,6918,26753,25.85878219265129
1996,MA,F,29039,3157,32196,9.805565908808548
1996,MA,M,23469,13841,37310,37.09729295095149
1996,MD,F,22119,2583,24702,10.456643186786495
1996,MD,M,19337,9518,28855,32.98561774389187
1996,ME,F,4303,497,4800,10.354166666666668
1996,ME,M,3679,2117,5796,36.52518978605935
1996,MI,F,47190,4831,52021,9.286634243863055
1996,MI,M,40998,18925,59923,31.58219715301303
1996,MN,F,22258,2599,24857,10.455807217282857
1996,MN,M,18527,10106,28633,35.29493940558097
1996,MO,F,26665,2862,29527,9.692823517458597
1996,MO,M,23684,10935,34619,31.586700944568015
1996,MS,F,10367,1239,11606,10.675512665862485
1996,MS,M,10932,4243,15175,27.960461285008236
1996,MT,F,2674,307,2981,10.298557531029855
1996,MT,M,2805,1283,4088,31.384540117416833
1996,NC,F,35240,4102,39342,10.42651619134767
1996,NC,M,31298,14805,46103,32.112877686918424
1996,ND,F,2723,284,3007,9.444629198536747
1996,ND,M,2503,1324,3827,34.596289521818655
1996,NE,F,7389,763,8152,9.359666339548577
1996,NE,M,6519,3362,9881,34.024896265560166
1996,NH,F,4443,581,5024,11.564490445859873
1996,NH,M,3928,2302,6230,36.95024077046549
1996,NJ,F,39062,3268,42330,7.720292936451689
1996,NJ,M,32452,16328,48780,33.47273472734727
1996,NM,F,8008,693,8701,7.964601769911504
1996,NM,M,7147,3682,10829,34.00129282482224
1996,NV,F,7649,600,8249,7.273608922293612
1996,NV,M,7171,3279,10450,31.37799043062201
1996,NY,F,96308,7966,104274,7.639488271285268
1996,NY,M,80969,38072,119041,31.982258213556676
1996,OH,F,55983,6029,62012,9.722311810617299
1996,OH,M,47462,23186,70648,32.81904654059563
1996,OK,F,14526,1445,15971,9.047648863565213
1996,OK,M,13509,5628,19137,29.408998275591784
1996,OR,F,15070,1579,16649,9.484053096282059
1996,OR,M,13518,6241,19759,31.58560655903639
1996,PA,F,54602,5898,60500,9.748760330578513
1996,PA,M,45224,23428,68652,34.12573559401037
1996,RI,F,3874,394,4268,9.23149015932521
1996,RI,M,3398,2157,5555,38.82988298829883
1996,SC,F,14479,1769,16248,10.887493845396357
1996,SC,M,13582,6123,19705,31.073331641715303
1996,SD,F,2806,286,3092,9.249676584734798
1996,SD,M,2763,1425,4188,34.02578796561605
1996,TN,F,26316,3288,29604,11.106607215241183
1996,TN,M,23258,11262,34520,32.62456546929317
1996,TX,F,129045,10474,139519,7.507221238684336
1996,TX,M,110252,45954,156206,29.418844346567997
1996,UT,F,13971,1258,15229,8.260555519075448
1996,UT,M,13590,5392,18982,28.405858181435047
1996,VA,F,30622,3514,34136,10.294117647058822
1996,VA,M,26315,12856,39171,32.820198616323296
1996,VT,F,1678,232,1910,12.146596858638743
1996,VT,M,1604,961,2565,37.46588693957115
1996,WA,F,25893,2641,28534,9.255624868577836
1996,WA,M,23231,10603,33834,31.338298752733934
1996,WI,F,22895,2430,25325,9.595261599210266
1996,WI,M,19410,10028,29438,34.064814185746314
1996,WV,F,6825,775,7600,10.197368421052632
1996,WV,M,6056,3179,9235,34.42338927991337
1996,WY,F,1205,142,1347,10.541945063103192
1996,WY,M,1358,666,2024,32.905138339920946
1997,AK,F,2204,326,2530,12.885375494071146
1997,AK,M,2122,1249,3371,37.051320083061405
1997,AL,F,18273,2461,20734,11.869393267097522
1997,AL,M,16905,7803,24708,31.580864497328797
1997,AR,F,10198,1279,11477,11.144027184804392
1997,AR,M,10263,4478,14741,30.377857675870025
1997,AZ,F,25896,2160,28056,7.698887938408896
1997,AZ,M,23934,10538,34472,30.569737758180555
1997,CA,F,207459,15338,222797,6.884293774153153
1997,CA,M,173605,72926,246531,29.580864069833
1997,CO,F,18971,1978,20949,9.441978137381259
1997,CO,M,16971,8172,25143,32.50208805631786
1997,CT,F,13875,1556,15431,10.083597952174195
1997,CT,M,11857,6686,18543,36.056732998975356
1997,DC,F,3046,414,3460,11.965317919075144
1997,DC,M,3268,1744,5012,34.79648842777334
1997,DE,F,2644,388,3032,12.796833773087071
1997,DE,M,2389,1542,3931,39.22665988298143
1997,FL,F,67561,5785,73346,7.887274016306274
1997,FL,M,60857,25402,86259,29.44852131371799
1997,GA,F,38212,4532,42744,10.602657682949653
1997,GA,M,35184,15241,50425,30.225086762518593
1997,HI,F,3443,301,3744,8.039529914529915
1997,HI,M,3392,1957,5349,36.58627780893625
1997,IA,F,12367,1345,13712,9.808926487747959
1997,IA,M,11239,5163,16402,31.477868552615533
1997,ID,F,5031,522,5553,9.40032414910859
1997,ID,M,5226,2280,7506,30.37569944044764
1997,IL,F,63609,6283,69892,8.989583929491216
1997,IL,M,54800,25213,80013,31.511129441465762
1997,IN,F,29521,3242,32763,9.895308732411563
1997,IN,M,25331,12271,37602,32.63390245199723
1997,KS,F,11190,1247,12437,10.026533729999196
1997,KS,M,10705,4875,15580,31.290115532734276
1997,KY,F,17652,2081,19733,10.545786246389296
1997,KY,M,15436,7934,23370,33.94950791613179
1997,LA,F,19612,2027,21639,9.367345995655992
1997,LA,M,19863,7108,26971,26.354232323606837
1997,MA,F,28460,3336,31796,10.491885771795193
1997,MA,M,23032,13418,36450,36.81207133058985
1997,MD,F,21089,2548,23637,10.779709777044465
1997,MD,M,18872,9387,28259,33.21773594253158
1997,ME,F,4021,560,4581,12.224405151713599
1997,ME,M,3670,2156,5826,37.00652248541023
1997,MI,F,46945,4983,51928,9.595979047912493
1997,MI,M,40885,18811,59696,31.511324041811843
1997,MN,F,22346,2618,24964,10.487101426053517
1997,MN,M,18941,10162,29103,34.917362471222894
1997,MO,F,26476,3001,29477,10.180818943583132
1997,MO,M,23728,10845,34573,31.368408873976804
1997,MS,F,10181,1335,11516,11.59256686349427
1997,MS,M,10630,4396,15026,29.255956342339946
1997,MT,F,2636,298,2934,10.156782549420585
1997,MT,M,2699,1345,4044,33.259149357072204
1997,NC,F,35693,4359,40052,10.883351642864277
1997,NC,M,32128,15172,47300,32.07610993657505
1997,ND,F,2558,283,2841,9.961281239000353
1997,ND,M,2548,1277,3825,33.38562091503268
1997,NE,F,7396,829,8225,10.0790273556231
1997,NE,M,6516,3327,9843,33.80067052727827
1997,NH,F,4321,592,4913,12.049664156319967
1997,NH,M,3795,2205,6000,36.75
1997,NJ,F,38388,3366,41754,8.061503089524356
1997,NJ,M,32194,16020,48214,33.226863566598915
1997,NM,F,7604,669,8273,8.086546597364922
1997,NM,M,7001,3706,10707,34.61287008499113
1997,NV,F,7856,687,8543,8.041671543954115
1997,NV,M,7389,3352,10741,31.207522577041242
1997,NY,F,92701,8221,100922,8.145894849487723
1997,NY,M,78445,36792,115237,31.9272455895242
1997,OH,F,55641,6105,61746,9.887280147701876
1997,OH,M,47196,23222,70418,32.977363742224995
1997,OK,F,15226,1575,16801,9.37444199750015
1997,OK,M,14189,6024,20213,29.80260228565775
1997,OR,F,14518,1620,16138,10.038418639236586
1997,OR,M,13261,6217,19478,31.91806140260807
1997,PA,F,52612,5605,58217,9.627771956644967
1997,PA,M,43723,22669,66392,34.144173996867096
1997,RI,F,3771,410,4181,9.806266443434584
1997,RI,M,3218,2038,5256,38.77473363774734
1997,SC,F,14292,1810,16102,11.240839647248789
1997,SC,M,13864,6414,20278,31.63033829766249
1997,SD,F,2744,296,3040,9.736842105263158
1997,SD,M,2611,1307,3918,33.35885655946912
1997,TN,F,25991,3400,29391,11.56816712599095
1997,TN,M,23494,11356,34850,32.58536585365854
1997,TX,F,129056,10821,139877,7.73608241526484
1997,TX,M,110613,46929,157542,29.788246943672164
1997,UT,F,14290,1290,15580,8.2798459563543
1997,UT,M,13769,5436,19205,28.305128872689405
1997,VA,F,29738,3504,33242,10.54088201672583
1997,VA,M,25775,13062,38837,33.63287586579808
1997,VT,F,1601,225,1826,12.322015334063527
1997,VT,M,1591,882,2473,35.66518398706025
1997,WA,F,25923,2701,28624,9.436137506987144
1997,WA,M,23352,10562,33914,31.143480568496784
1997,WI,F,22472,2455,24927,9.848758374453404
1997,WI,M,19200,9713,28913,33.59388510358662
1997,WV,F,6502,832,7334,11.344423234251432
1997,WV,M,6124,3201,9325,34.32707774798928
1997,WY,F,1141,163,1304,12.5
1997,WY,M,1323,674,1997,33.750625938908364
1998,AK,F,2265,323,2588,12.480680061823803
1998,AK,M,2083,1275,3358,37.969029184038114
1998,AL,F,18357,2480,20837,11.901905264673418
1998,AL,M,17523,7900,25423,31.074224127758328
1998,AR,F,10564,1333,11897,11.204505337480036
1998,AR,M,10108,4460,14568,30.615046677649644
1998,AZ,F,26988,2211,29199,7.572177129353745
1998,AZ,M,24096,10943,35039,31.23091412426154
1998,CA,F,205335,15599,220934,7.060479600242607
1998,CA,M,170834,73794,244628,30.16580276992004
1998,CO,F,20160,2088,22248,9.385113268608414
1998,CO,M,17983,8392,26375,31.818009478672987
1998,CT,F,13871,1662,15533,10.699800424901822
1998,CT,M,11952,6801,18753,36.266197408414655
1998,DC,F,3120,392,3512,11.161731207289293
1998,DC,M,3240,1723,4963,34.71690509772315
1998,DE,F,2786,358,3144,11.38676844783715
1998,DE,M,2432,1479,3911,37.816415239069286
1998,FL,F,68129,6124,74253,8.247478216368362
1998,FL,M,60969,26319,87288,30.15191091558977
1998,GA,F,39857,4675,44532,10.498068804455222
1998,GA,M,36163,15810,51973,30.419640967425394
1998,HI,F,3463,337,3800,8.868421052631579
1998,HI,M,3302,1968,5270,37.34345351043643
1998,IA,F,12676,1368,14044,9.74081458273996
1998,IA,M,11231,5316,16547,32.12666948691606
1998,ID,F,5352,544,5896,9.226594301221166
1998,ID,M,5354,2300,7654,30.049647243271494
1998,IL,F,64380,6010,70390,8.538144622815741
1998,IL,M,55694,25116,80810,31.080311842593737
1998,IN,F,29835,3218,33053,9.735878740205125
1998,IN,M,26061,12419,38480,32.273908523908524
1998,KS,F,11703,1247,12950,9.62934362934363
1998,KS,M,10963,4962,15925,31.1585557299843
1998,KY,F,18173,2205,20378,10.820492688193148
1998,KY,M,15688,7968,23656,33.6827866080487
1998,LA,F,19776,2065,21841,9.454695297834348
1998,LA,M,20227,7178,27405,26.192300675059293
1998,MA,F,28518,3370,31888,10.56823883592574
1998,MA,M,23481,13483,36964,36.4760307326047
1998,MD,F,21430,2499,23929,10.44339504367086
1998,MD,M,19152,9558,28710,33.291536050156736
1998,ME,F,4082,549,4631,11.854890952278126
1998,ME,M,3643,2144,5787,37.04855711076551
1998,MI,F,46487,4990,51477,9.693649591079511
1998,MI,M,41551,18729,60280,31.070006635700064
1998,MN,F,22623,2628,25251,10.407508613520257
1998,MN,M,18921,9915,28836,34.38410320432793
1998,MO,F,26670,2986,29656,10.06878877798759
1998,MO,M,23822,11068,34890,31.722556606477504
1998,MS,F,10830,1349,12179,11.076443057722308
1998,MS,M,10958,4464,15422,28.94566204123979
1998,MT,F,2541,321,2862,11.215932914046121
1998,MT,M,2804,1214,4018,30.214036834245896
1998,NC,F,37501,4586,42087,10.896476346615344
1998,NC,M,33108,15889,48997,32.42851603159377
1998,ND,F,2365,290,2655,10.922787193973635
1998,ND,M,2381,1192,3573,33.36132101875175
1998,NE,F,7279,809,8088,10.002472799208704
1998,NE,M,6826,3277,10103,32.435910125705234
1998,NH,F,4205,635,4840,13.119834710743802
1998,NH,M,3860,2265,6125,36.97959183673469
1998,NJ,F,38003,3472,41475,8.371308016877638
1998,NJ,M,32650,16199,48849,33.16137484902455
1998,NM,F,7843,619,8462,7.315055542424958
1998,NM,M,7071,3787,10858,34.877509670289186
1998,NV,F,8404,723,9127,7.921551440780103
1998,NV,M,7818,3561,11379,31.294489849723174
1998,NY,F,92285,8363,100648,8.309156664812019
1998,NY,M,78856,36999,115855,31.9356091666307
1998,OH,F,55423,6069,61492,9.869576530280362
1998,OH,M,47538,23040,70578,32.64473348635552
1998,OK,F,15314,1590,16904,9.406057737813535
1998,OK,M,14709,6120,20829,29.38211147918767
1998,OR,F,14903,1530,16433,9.310533682224792
1998,OR,M,13789,6380,20169,31.63270365412266
1998,PA,F,52273,5957,58230,10.23012193027649
1998,PA,M,44632,22668,67300,33.682020802377416
1998,RI,F,3723,418,4141,10.09418014972229
1998,RI,M,3301,2146,5447,39.39783366991004
1998,SC,F,14855,1928,16783,11.487815050944409
1998,SC,M,14162,6530,20692,31.558090083123915
1998,SD,F,2623,283,2906,9.73847212663455
1998,SD,M,2703,1325,4028,32.89473684210527
1998,TN,F,27113,3404,30517,11.154438509683127
1998,TN,M,24325,12053,36378,33.13266259827368
1998,TX,F,132199,11223,143422,7.825159320048527
1998,TX,M,113054,48382,161436,29.96977130255953
1998,UT,F,15029,1489,16518,9.014408524034387
1998,UT,M,14030,5787,19817,29.202200131200485
1998,VA,F,30243,3647,33890,10.761286515196224
1998,VA,M,26937,13114,40051,32.74325235324961
1998,VT,F,1690,242,1932,12.525879917184266
1998,VT,M,1510,868,2378,36.501261564339785
1998,WA,F,26531,2682,29213,9.180844144730086
1998,WA,M,23977,10735,34712,30.92590458631021
1998,WI,F,22584,2540,25124,10.109855118611687
1998,WI,M,19535,9697,29232,33.17255062944719
1998,WV,F,6558,758,7316,10.36085292509568
1998,WV,M,5913,3080,8993,34.24886022461915
1998,WY,F,1146,164,1310,12.51908396946565
1998,WY,M,1321,618,1939,31.87209902011346
1999,AK,F,2091,266,2357,11.285532456512517
1999,AK,M,2154,1266,3420,37.01754385964912
1999,AL,F,18552,2533,21085,12.013279582641688
1999,AL,M,17334,7815,25149,31.07479422641059
1999,AR,F,10388,1389,11777,11.794175087034048
1999,AR,M,10143,4340,14483,29.96616723054616
1999,AZ,F,28109,2319,30428,7.621269883002498
1999,AZ,M,25102,11301,36403,31.044144713347798
1999,CA,F,203807,15186,218993,6.934468225011758
1999,CA,M,170011,73088,243099,30.065117503568505
1999,CO,F,20914,2148,23062,9.314023068250803
1999,CO,M,18748,8776,27524,31.884900450515914
1999,CT,F,13676,1661,15337,10.830018908521875
1999,CT,M,11712,6663,18375,36.26122448979592
1999,DC,F,3036,389,3425,11.357664233576642
1999,DC,M,3049,1672,4721,35.416225375979664
1999,DE,F,2761,346,3107,11.136144190537497
1999,DE,M,2471,1571,4042,38.86689757545769
1999,FL,F,68428,6255,74683,8.37540002410187
1999,FL,M,61333,26123,87456,29.86987742407611
1999,GA,F,40916,4799,45715,10.49764847424259
1999,GA,M,37815,16482,54297,30.35526824686447
1999,HI,F,3228,258,3486,7.401032702237521
1999,HI,M,3246,1874,5120,36.6015625
1999,IA,F,12419,1320,13739,9.607686148919136
1999,IA,M,11548,5252,16800,31.261904761904763
1999,ID,F,5458,516,5974,8.637428858386341
1999,ID,M,5375,2331,7706,30.24915650142746
1999,IL,F,63737,6073,69810,8.699326744019482
1999,IL,M,55404,24945,80349,31.04581264234776
1999,IN,F,29744,3447,33191,10.385345424964598
1999,IN,M,26437,12462,38899,32.036813285688574
1999,KS,F,11872,1242,13114,9.470794570687815
1999,KS,M,11294,5085,16379,31.045851395079065
1999,KY,F,17896,2154,20050,10.743142144638403
1999,KY,M,15737,7969,23706,33.61596220366152
1999,LA,F,19941,2093,22034,9.498956158663884
1999,LA,M,20384,7147,27531,25.959827103991863
1999,MA,F,27897,3453,31350,11.014354066985646
1999,MA,M,23388,13175,36563,36.03369526570577
1999,MD,F,21372,2560,23932,10.696974761825171
1999,MD,M,19066,9572,28638,33.42412179621482
1999,ME,F,3882,523,4405,11.872871736662884
1999,ME,M,3721,2048,5769,35.50008667013348
1999,MI,F,46351,4864,51215,9.497217612027727
1999,MI,M,40749,18683,59432,31.435926773455375
1999,MN,F,22406,2555,24961,10.235968110251994
1999,MN,M,19593,9865,29458,33.488356303890285
1999,MO,F,26355,2876,29231,9.838869693134003
1999,MO,M,23730,10649,34379,30.97530469181768
1999,MS,F,10450,1355,11805,11.478187208809826
1999,MS,M,10835,4475,15310,29.22926192031352
1999,MT,F,2481,289,2770,10.43321299638989
1999,MT,M,2788,1253,4041,31.007176441474883
1999,NC,F,37736,4753,42489,11.186424721692674
1999,NC,M,33353,16419,49772,32.98842722816041
1999,ND,F,2326,282,2608,10.812883435582823
1999,ND,M,2248,1182,3430,34.46064139941691
1999,NE,F,7235,760,7995,9.505941213258287
1999,NE,M,6855,3310,10165,32.56271519921299
1999,NH,F,4199,568,4767,11.915250681770505
1999,NH,M,3677,2209,5886,37.529731566428815
1999,NJ,F,37930,3591,41521,8.64863563016305
1999,NJ,M,31716,15947,47663,33.4578184335858
1999,NM,F,7494,612,8106,7.549962990377498
1999,NM,M,7085,3779,10864,34.78460972017673
1999,NV,F,8505,717,9222,7.774886141834743
1999,NV,M,8193,3670,11863,30.936525330860658
1999,NY,F,91198,8538,99736,8.560599983957648
1999,NY,M,77845,36442,114287,31.88639127809812
1999,OH,F,55197,6224,61421,10.133342016574137
1999,OH,M,46981,23146,70127,33.00583227572832
1999,OK,F,15084,1593,16677,9.552077711818672
1999,OK,M,14374,6023,20397,29.528852282198365
1999,OR,F,14730,1577,16307,9.67069356717974
1999,OR,M,13536,6471,20007,32.343679712100766
1999,PA,F,51954,5869,57823,10.14994033516075
1999,PA,M,44199,22442,66641,33.675965246619946
1999,RI,F,3669,480,4149,11.569052783803325
1999,RI,M,3119,2072,5191,39.915237911770376
1999,SC,F,14958,2002,16960,11.804245283018867
1999,SC,M,14041,6722,20763,32.37489765448153
1999,SD,F,2714,328,3042,10.782380013149243
1999,SD,M,2811,1315,4126,31.871061560833734
1999,TN,F,27095,3512,30607,11.474499297546313
1999,TN,M,24626,11923,36549,32.6219595611371
1999,TX,F,135846,11326,147172,7.695757345147175
1999,TX,M,116378,49323,165701,29.766265743719106
1999,UT,F,15133,1467,16600,8.837349397590362
1999,UT,M,14881,5879,20760,28.31888246628131
1999,VA,F,30782,3558,34340,10.361094933022715
1999,VA,M,27048,13182,40230,32.76659209545116
1999,VT,F,1533,250,1783,14.021312394840157
1999,VT,M,1510,896,2406,37.2402327514547
1999,WA,F,26445,2754,29199,9.431829857186889
1999,WA,M,24002,10848,34850,31.127690100430417
1999,WI,F,22648,2476,25124,9.855118611686036
1999,WI,M,19861,9692,29553,32.795316888302374
1999,WV,F,6423,849,7272,11.674917491749175
1999,WV,M,5812,3149,8961,35.14116728043745
1999,WY,F,1059,139,1198,11.602671118530884
1999,WY,M,1243,640,1883,33.98831651619756
2000,AK,F,1978,301,2279,13.20754716981132
2000,AK,M,2113,1240,3353,36.98180733671339
2000,AL,F,18511,2609,21120,12.353219696969697
2000,AL,M,17386,8137,25523,31.88104846608941
2000,AR,F,10730,1420,12150,11.68724279835391
2000,AR,M,10519,4467,14986,29.80782063259042
2000,AZ,F,29560,2329,31889,7.3034588729656
2000,AZ,M,26644,11496,38140,30.141583639223914
2000,CA,F,208219,15461,223680,6.912106580829756
2000,CA,M,175236,73907,249143,29.664489871278743
2000,CO,F,21847,2219,24066,9.220477021524141
2000,CO,M,19713,8928,28641,31.172095946370586
2000,CT,F,13545,1619,15164,10.676602479556845
2000,CT,M,11778,6557,18335,35.76220343605127
2000,DC,F,3103,437,3540,12.344632768361583
2000,DC,M,3210,1687,4897,34.44966305901572
2000,DE,F,2680,357,3037,11.755021402700033
2000,DE,M,2552,1709,4261,40.10795587890167
2000,FL,F,70694,6580,77274,8.515153868053938
2000,FL,M,63277,26586,89863,29.58503499771875
2000,GA,F,42900,5141,48041,10.701275993422286
2000,GA,M,39257,16547,55804,29.651996272668622
2000,HI,F,3270,326,3596,9.06562847608454
2000,HI,M,3339,1960,5299,36.98811096433289
2000,IA,F,12752,1413,14165,9.975291210730674
2000,IA,M,11734,5109,16843,30.333076055334562
2000,ID,F,5477,593,6070,9.769357495881383
2000,ID,M,5579,2337,7916,29.522486104092977
2000,IL,F,64955,6259,71214,8.78900216249614
2000,IL,M,56368,24615,80983,30.39526814269661
2000,IN,F,29948,3324,33272,9.990382303438325
2000,IN,M,27285,12469,39754,31.365397192735323
2000,KS,F,11973,1364,13337,10.227187523431057
2000,KS,M,11665,4977,16642,29.906261266674676
2000,KY,F,18166,2263,20429,11.077389984825494
2000,KY,M,16192,8234,24426,33.70998116760829
2000,LA,F,19734,2173,21907,9.91920390742685
2000,LA,M,20374,7067,27441,25.75343464159469
2000,MA,F,27888,3506,31394,11.167739058418807
2000,MA,M,23488,13007,36495,35.64049869845184
2000,MD,F,21865,2721,24586,11.067274058407223
2000,MD,M,19410,9585,28995,33.057423693740304
2000,ME,F,3941,557,4498,12.383281458425968
2000,ME,M,3545,2054,5599,36.68512234327558
2000,MI,F,46894,5078,51972,9.770645732317401
2000,MI,M,41365,18510,59875,30.91440501043841
2000,MN,F,22885,2731,25616,10.661305434103685
2000,MN,M,19884,9763,29647,32.93081930718117
2000,MO,F,26265,3087,29352,10.517170891251022
2000,MO,M,23770,10846,34616,31.33233186965565
2000,MS,F,10535,1489,12024,12.38356620093147
2000,MS,M,11215,4432,15647,28.324918514731255
2000,MT,F,2605,313,2918,10.726525017135025
2000,MT,M,2754,1274,4028,31.628599801390266
2000,NC,F,40106,4976,45082,11.037664699880219
2000,NC,M,35421,16846,52267,32.23066179424876
2000,ND,F,2131,287,2418,11.869313482216707
2000,ND,M,2362,1105,3467,31.871935390827804
2000,NE,F,7511,844,8355,10.101735487731897
2000,NE,M,6977,3315,10292,32.20948309366498
2000,NH,F,3987,590,4577,12.890539654795719
2000,NH,M,3790,2254,6044,37.29318332230311
2000,NJ,F,37867,3879,41746,9.291908206774302
2000,NJ,M,32447,15709,48156,32.62106487249772
2000,NM,F,7532,612,8144,7.514734774066797
2000,NM,M,6943,3779,10722,35.24529005782504
2000,NV,F,8722,769,9491,8.102412812137814
2000,NV,M,8707,3757,12464,30.142811296534017
2000,NY,F,91531,8817,100348,8.786423247100092
2000,NY,M,79016,36062,115078,31.337006204487388
2000,OH,F,55597,6260,61857,10.12011575084469
2000,OH,M,48331,22858,71189,32.108893227886334
2000,OK,F,15176,1593,16769,9.499672013835053
2000,OK,M,14676,6099,20775,29.35740072202166
2000,OR,F,14878,1580,16458,9.600194434317658
2000,OR,M,13612,6351,19963,31.8138556329209
2000,PA,F,51946,6022,57968,10.388490201490477
2000,PA,M,44455,21844,66299,32.94770660190953
2000,RI,F,3322,476,3798,12.53291205897841
2000,RI,M,3275,2056,5331,38.56687300694054
2000,SC,F,14916,1985,16901,11.744867167623218
2000,SC,M,14317,6782,21099,32.14370349305654
2000,SD,F,2547,328,2875,11.408695652173913
2000,SD,M,2722,1214,3936,30.843495934959346
2000,TN,F,27595,3531,31126,11.34421384051918
2000,TN,M,24860,12059,36919,32.663398250223466
2000,TX,F,141380,11753,153133,7.675027590395277
2000,TX,M,122238,50074,172312,29.060077069501833
2000,UT,F,15418,1613,17031,9.470964711408609
2000,UT,M,15205,5861,21066,27.82208297730941
2000,VA,F,31450,4067,35517,11.450854520370527
2000,VA,M,27840,13573,41413,32.774732571897715
2000,VT,F,1490,248,1738,14.2692750287687
2000,VT,M,1491,919,2410,38.13278008298755
2000,WA,F,26476,2880,29356,9.810600899305083
2000,WA,M,24347,10635,34982,30.401349265336457
2000,WI,F,22897,2472,25369,9.744175962789232
2000,WI,M,20305,9464,29769,31.791460915717696
2000,WV,F,6470,799,7269,10.991883340211858
2000,WV,M,6022,3268,9290,35.177610333692144
2000,WY,F,1121,137,1258,10.890302066772655
2000,WY,M,1160,602,1762,34.165720771850175
2001,AK,F,2075,258,2333,11.05872267466781
2001,AK,M,2149,1174,3323,35.329521516701774
2001,AL,F,17421,2544,19965,12.742299023290759
2001,AL,M,16693,7622,24315,31.34690520254987
2001,AR,F,10253,1406,11659,12.0593532893044
2001,AR,M,10375,4386,14761,29.71343404918366
2001,AZ,F,29585,2388,31973,7.468801801520033
2001,AZ,M,26632,11385,38017,29.947128916011255
2001,CA,F,206896,15244,222140,6.862339065454218
2001,CA,M,172717,73102,245819,29.73814066447264
2001,CO,F,22204,2240,24444,9.163802978235967
2001,CO,M,20505,8871,29376,30.19812091503268
2001,CT,F,13226,1680,14906,11.270629276801287
2001,CT,M,11885,6245,18130,34.445670159955874
2001,DC,F,3176,443,3619,12.24095053882288
2001,DC,M,3014,1635,4649,35.16885351688535
2001,DE,F,2625,393,3018,13.021868787276341
2001,DE,M,2394,1533,3927,39.037433155080215
2001,FL,F,70690,6595,77285,8.533350585495244
2001,FL,M,63770,26617,90387,29.44781882350338
2001,GA,F,43179,5029,48208,10.431878526385663
2001,GA,M,39350,16603,55953,29.67311851017819
2001,HI,F,3137,299,3436,8.701979045401629
2001,HI,M,3096,1674,4770,35.094339622641506
2001,IA,F,12298,1401,13699,10.2270238703555
2001,IA,M,11484,4761,16245,29.30747922437673
2001,ID,F,5632,554,6186,8.95570643388296
2001,ID,M,5495,2337,7832,29.8391215526047
2001,IL,F,64092,6250,70342,8.88516107019988
2001,IL,M,56552,24135,80687,29.91188171576586
2001,IN,F,29670,3321,32991,10.066381740474675
2001,IN,M,26965,11848,38813,30.525854739391438
2001,KS,F,11950,1297,13247,9.790896051936288
2001,KS,M,11478,4835,16313,29.638938270091337
2001,KY,F,17711,2182,19893,10.968682451113457
2001,KY,M,15716,7774,23490,33.09493401447424
2001,LA,F,18596,2165,20761,10.428206733779682
2001,LA,M,19325,6916,26241,26.35570290766358
2001,MA,F,27882,3561,31443,11.325255223738193
2001,MA,M,23348,12481,35829,34.834910268218486
2001,MD,F,21331,2681,24012,11.165250707979343
2001,MD,M,19182,9341,28523,32.749009571223226
2001,ME,F,3902,558,4460,12.51121076233184
2001,ME,M,3710,2036,5746,35.43334493560738
2001,MI,F,44978,4865,49843,9.76064843608932
2001,MI,M,41114,17864,58978,30.289260402183864
2001,MN,F,22512,2705,25217,10.726890589681563
2001,MN,M,19908,9620,29528,32.57924681658087
2001,MO,F,25552,2995,28547,10.491470207027008
2001,MO,M,23605,10048,33653,29.85766499271982
2001,MS,F,10140,1453,11593,12.533425342879323
2001,MS,M,10464,4313,14777,29.18725045679096
2001,MT,F,2480,306,2786,10.983488872936109
2001,MT,M,2715,1136,3851,29.498831472344843
2001,NC,F,39371,4844,44215,10.955558068528779
2001,NC,M,34637,16338,50975,32.05100539480137
2001,ND,F,2282,265,2547,10.404397330192383
2001,ND,M,2182,949,3131,30.309805174065797
2001,NE,F,7354,827,8181,10.10878865664344
2001,NE,M,7034,3144,10178,30.890155236785223
2001,NH,F,4207,635,4842,13.114415530772408
2001,NH,M,3735,2077,5812,35.73640743289745
2001,NJ,F,37598,3792,41390,9.161633244745108
2001,NJ,M,32594,15747,48341,32.57483295753087
2001,NM,F,7425,587,8012,7.326510234648027
2001,NM,M,6945,3666,10611,34.549052869663555
2001,NV,F,9092,791,9883,8.003642618638066
2001,NV,M,8700,3755,12455,30.148534725010034
2001,NY,F,89319,8546,97865,8.732437541511265
2001,NY,M,77032,35075,112107,31.287073956131195
2001,OH,F,53329,6117,59446,10.290011102513205
2001,OH,M,46887,22021,68908,31.957102223254193
2001,OK,F,15138,1573,16711,9.412961522350548
2001,OK,M,14484,5972,20456,29.1943684004693
2001,OR,F,14419,1515,15934,9.50797037780846
2001,OR,M,13498,6090,19588,31.090463549111703
2001,PA,F,49984,5924,55908,10.59597910853545
2001,PA,M,43361,21366,64727,33.009408747508765
2001,RI,F,3524,454,3978,11.412770236299648
2001,RI,M,3194,1920,5114,37.5439968713336
2001,SC,F,14687,2087,16774,12.441874329319184
2001,SC,M,13974,6781,20755,32.67164538665382
2001,SD,F,2734,303,3037,9.976950938426079
2001,SD,M,2696,1205,3901,30.889515508843886
2001,TN,F,26524,3617,30141,12.000265419196444
2001,TN,M,24531,11562,36093,32.03391239298479
2001,TX,F,141486,11686,153172,7.629331731648081
2001,TX,M,122765,50039,172804,28.957084326751698
2001,UT,F,15817,1509,17326,8.709453999769133
2001,UT,M,15496,5822,21318,27.310254245238763
2001,VA,F,31166,3912,35078,11.152289184103997
2001,VA,M,27705,13458,41163,32.69441002842358
2001,VT,F,1463,220,1683,13.071895424836603
2001,VT,M,1448,868,2316,37.47841105354059
2001,WA,F,25970,2749,28719,9.572060308506563
2001,WA,M,23773,10229,34002,30.083524498558905
2001,WI,F,22545,2586,25131,10.290079980900083
2001,WI,M,20141,8947,29088,30.758388338833882
2001,WV,F,6323,810,7133,11.355670825739521
2001,WV,M,5754,3103,8857,35.03443603929096
2001,WY,F,981,114,1095,10.41095890410959
2001,WY,M,1211,600,1811,33.13086692435119
2002,AK,F,2022,258,2280,11.31578947368421
2002,AK,M,2034,1195,3229,37.00836172189532
2002,AL,F,16911,2572,19483,13.201252373864394
2002,AL,M,16160,7200,23360,30.82191780821918
2002,AR,F,10490,1319,11809,11.169447031924804
2002,AR,M,10409,4336,14745,29.406578501186843
2002,AZ,F,30102,2278,32380,7.035206917850526
2002,AZ,M,27353,11734,39087,30.02021132345793
2002,CA,F,208023,14590,222613,6.553974835252209
2002,CA,M,173688,72399,246087,29.420083141328067
2002,CO,F,22723,2106,24829,8.48201699625438
2002,CO,M,21313,8853,30166,29.347609891931313
2002,CT,F,13016,1615,14631,11.038206547741098
2002,CT,M,11734,6076,17810,34.11566535654127
2002,DC,F,3050,437,3487,12.532262689991397
2002,DC,M,3044,1685,4729,35.63121167265807
2002,DE,F,2636,398,3034,13.117996044825315
2002,DE,M,2618,1501,4119,36.440883709638264
2002,FL,F,70604,6358,76962,8.261219822769679
2002,FL,M,64241,26241,90482,29.001348334475363
2002,GA,F,43433,4949,48382,10.229010789136456
2002,GA,M,39721,16413,56134,29.23896390779207
2002,HI,F,2987,270,3257,8.28983727356463
2002,HI,M,3320,1855,5175,35.84541062801932
2002,IA,F,12114,1362,13476,10.10685663401603
2002,IA,M,11746,4680,16426,28.491416047729214
2002,ID,F,5639,570,6209,9.180222258012563
2002,ID,M,5876,2250,8126,27.688899827713513
2002,IL,F,62721,5919,68640,8.623251748251748
2002,IL,M,55766,23096,78862,29.28660191220106
2002,IN,F,28991,3242,32233,10.058015077715385
2002,IN,M,26343,11253,37596,29.931375678263645
2002,KS,F,12207,1235,13442,9.18762088974855
2002,KS,M,11680,4896,16576,29.53667953667954
2002,KY,F,17178,2072,19250,10.763636363636364
2002,KY,M,15901,7438,23339,31.869403144950514
2002,LA,F,18504,2010,20514,9.798186604270255
2002,LA,M,19241,6687,25928,25.790651033631594
2002,MA,F,27237,3431,30668,11.187557062736403
2002,MA,M,23505,12260,35765,34.279323360827625
2002,MD,F,21168,2576,23744,10.849056603773585
2002,MD,M,19295,9210,28505,32.310121031398
2002,ME,F,3808,594,4402,13.493866424352566
2002,ME,M,3619,1938,5557,34.87493251754544
2002,MI,F,44010,4675,48685,9.602546985724555
2002,MI,M,39913,16650,56563,29.436203878860738
2002,MN,F,22610,2759,25369,10.875477945524064
2002,MN,M,20407,9217,29624,31.113286524439644
2002,MO,F,24896,2936,27832,10.549008335728658
2002,MO,M,23440,10085,33525,30.082028337061896
2002,MS,F,9912,1400,11312,12.376237623762377
2002,MS,M,10376,4280,14656,29.203056768558948
2002,MT,F,2445,300,2745,10.92896174863388
2002,MT,M,2807,1113,3920,28.392857142857142
2002,NC,F,38720,4692,43412,10.808071500967474
2002,NC,M,34776,15935,50711,31.423162627437833
2002,ND,F,2019,288,2307,12.483745123537062
2002,ND,M,2356,1048,3404,30.787309048178614
2002,NE,F,7481,806,8287,9.726076988053578
2002,NE,M,7356,3001,10357,28.97557207685623
2002,NH,F,3933,607,4540,13.370044052863436
2002,NH,M,3737,2057,5794,35.5022437003797
2002,NJ,F,37422,3777,41199,9.167698245103036
2002,NJ,M,32484,15484,47968,32.27985323549032
2002,NM,F,7725,587,8312,7.062078922040424
2002,NM,M,7068,3589,10657,33.67739513934503
2002,NV,F,9442,744,10186,7.304142941291969
2002,NV,M,8962,3896,12858,30.300202208741638
2002,NY,F,88393,8401,96794,8.679256978738351
2002,NY,M,76834,33794,110628,30.54742018295549
2002,OH,F,52265,5808,58073,10.001205379436227
2002,OH,M,46490,21076,67566,31.193203682325432
2002,OK,F,15067,1527,16594,9.202121248644088
2002,OK,M,14847,5877,20724,28.35842501447597
2002,OR,F,14569,1455,16024,9.080129805292062
2002,OR,M,13528,5939,19467,30.508039245903323
2002,PA,F,49175,5988,55163,10.855102151804651
2002,PA,M,43299,20546,63845,32.18106351319602
2002,RI,F,3442,467,3909,11.946789460220005
2002,RI,M,3268,1967,5235,37.574021012416424
2002,SC,F,14511,1981,16492,12.01188455008489
2002,SC,M,13869,6368,20237,31.467114690912684
2002,SD,F,2612,338,2950,11.457627118644067
2002,SD,M,2817,1181,3998,29.539769884942473
2002,TN,F,26493,3493,29986,11.64876942573201
2002,TN,M,24026,11210,35236,31.814053808604836
2002,TX,F,144557,11334,155891,7.270464619509785
2002,TX,M,125068,50272,175340,28.671153188091708
2002,UT,F,15938,1651,17589,9.386548410938655
2002,UT,M,15542,6034,21576,27.96625880608083
2002,VA,F,31730,3906,35636,10.960826130878887
2002,VA,M,27690,13100,40790,32.11571463594018
2002,VT,F,1358,247,1605,15.389408099688474
2002,VT,M,1532,751,2283,32.89531318440648
2002,WA,F,25768,2638,28406,9.286770400619588
2002,WA,M,23716,10016,33732,29.69287323609629
2002,WI,F,22281,2445,24726,9.888376607619511
2002,WI,M,20181,8750,28931,30.24437454633438
2002,WV,F,6314,822,7136,11.519058295964125
2002,WV,M,5896,3042,8938,34.034459610651155
2002,WY,F,1102,136,1238,10.98546042003231
2002,WY,M,1264,585,1849,31.63872363439697
2003,AK,F,1961,264,2225,11.865168539325843
2003,AK,M,2167,1073,3240,33.117283950617285
2003,AL,F,17362,2263,19625,11.531210191082803
2003,AL,M,16591,7197,23788,30.254750294266014
2003,AR,F,10637,1262,11899,10.605933271703504
2003,AR,M,10511,4428,14939,29.640538188633776
2003,AZ,F,31268,2365,33633,7.031784259507032
2003,AZ,M,28446,11773,40219,29.272234516024763
2003,CA,F,211865,14646,226511,6.465911147802976
2003,CA,M,179410,72780,252190,28.85919346524446
2003,CO,F,23029,2185,25214,8.665820575870548
2003,CO,M,21542,8936,30478,29.319509154143976
2003,CT,F,13214,1566,14780,10.595399188092017
2003,CT,M,11845,6095,17940,33.97435897435898
2003,DC,F,2964,406,3370,12.047477744807122
2003,DC,M,3016,1655,4671,35.4313851423678
2003,DE,F,2808,379,3187,11.892061499843113
2003,DE,M,2603,1559,4162,37.45795290725613
2003,FL,F,73381,6397,79778,8.01850134122189
2003,FL,M,67161,26794,93955,28.517907508913844
2003,GA,F,44681,5025,49706,10.109443527944313
2003,GA,M,41128,16321,57449,28.409545858065417
2003,HI,F,3237,286,3523,8.118081180811808
2003,HI,M,3427,1802,5229,34.46165614840314
2003,IA,F,12391,1295,13686,9.462224170685372
2003,IA,M,11939,4471,16410,27.245581962218157
2003,ID,F,5774,597,6371,9.370585465390048
2003,ID,M,6058,2352,8410,27.966706302021404
2003,IL,F,63253,5975,69228,8.63090079158722
2003,IL,M,56968,22671,79639,28.467208277351546
2003,IN,F,29209,3145,32354,9.720590962477592
2003,IN,M,27387,11327,38714,29.258149506638425
2003,KS,F,12341,1302,13643,9.543355566957414
2003,KS,M,12128,4639,16767,27.667441999165028
2003,KY,F,17574,2096,19670,10.65582104728012
2003,KY,M,15715,7512,23227,32.34167133077884
2003,LA,F,18707,2049,20756,9.871844285989594
2003,LA,M,19294,6567,25861,25.393449595916636
2003,MA,F,26920,3282,30202,10.866830011257532
2003,MA,M,23597,11693,35290,33.13403230376878
2003,MD,F,21786,2448,24234,10.1015102748205
2003,MD,M,20277,9099,29376,30.974264705882355
2003,ME,F,3769,577,4346,13.276576161988036
2003,ME,M,3748,1887,5635,33.4871339840284
2003,MI,F,44374,4617,48991,9.424179951419648
2003,MI,M,40587,16500,57087,28.90325292973882
2003,MN,F,23199,2691,25890,10.393974507531865
2003,MN,M,21299,9030,30329,29.773484124105643
2003,MO,F,25680,2720,28400,9.577464788732394
2003,MO,M,24317,9580,33897,28.26208809039148
2003,MS,F,10223,1304,11527,11.31257048668344
2003,MS,M,10833,4212,15045,27.996011964107677
2003,MT,F,2575,316,2891,10.930473884469041
2003,MT,M,2853,1189,4042,29.41613062840178
2003,NC,F,38902,4570,43472,10.512513801987486
2003,NC,M,35570,15749,51319,30.688438979715116
2003,ND,F,2276,296,2572,11.508553654743391
2003,ND,M,2331,944,3275,28.824427480916032
2003,NE,F,7492,791,8283,9.549680067608355
2003,NE,M,7650,2988,10638,28.08798646362098
2003,NH,F,4046,531,4577,11.601485689316146
2003,NH,M,3720,1927,5647,34.12431379493536
2003,NJ,F,38300,3882,42182,9.202977573372529
2003,NJ,M,33238,15296,48534,31.516050603700496
2003,NM,F,7503,605,8108,7.461766156882092
2003,NM,M,7152,3502,10654,32.87028346161066
2003,NV,F,9577,749,10326,7.25353476660856
2003,NV,M,9424,3839,13263,28.945185855387166
2003,NY,F,89305,8706,98011,8.882676434277785
2003,NY,M,78300,33821,112121,30.164732744088973
2003,OH,F,52512,5624,58136,9.673868171184807
2003,OH,M,47465,20093,67558,29.741851446164773
2003,OK,F,15138,1471,16609,8.856643988199169
2003,OK,M,15182,5763,20945,27.514920028646454
2003,OR,F,14715,1512,16227,9.317803660565724
2003,OR,M,14079,5670,19749,28.710314446301076
2003,PA,F,50562,5870,56432,10.4018996314148
2003,PA,M,44705,19953,64658,30.859290420365614
2003,RI,F,3400,498,3898,12.775782452539763
2003,RI,M,3307,1987,5294,37.53305629013978
2003,SC,F,14973,1970,16943,11.627220681107243
2003,SC,M,14254,6474,20728,31.23311462755693
2003,SD,F,2871,328,3199,10.253204126289466
2003,SD,M,2918,1172,4090,28.655256723716384
2003,TN,F,26918,3444,30362,11.343126276266386
2003,TN,M,24826,11095,35921,30.887224743186437
2003,TX,F,146619,11380,157999,7.202577231501466
2003,TX,M,128066,49348,177414,27.815166785033874
2003,UT,F,16452,1591,18043,8.817824086903508
2003,UT,M,16105,5647,21752,25.96083118793674
2003,VA,F,32318,3702,36020,10.277623542476402
2003,VA,M,28649,13128,41777,31.423989276396103
2003,VT,F,1364,244,1608,15.17412935323383
2003,VT,M,1532,791,2323,34.050796383986224
2003,WA,F,26174,2663,28837,9.234663799979193
2003,WA,M,24183,9870,34053,28.984230464276273
2003,WI,F,22556,2425,24981,9.707377606981305
2003,WI,M,20954,8372,29326,28.5480461024347
2003,WV,F,6410,798,7208,11.07103218645949
2003,WV,M,6120,3034,9154,33.14398077343238
2003,WY,F,1038,136,1174,11.584327086882453
2003,WY,M,1365,655,2020,32.42574257425743
2004,AK,F,2037,280,2317,12.084592145015106
2004,AK,M,2164,1137,3301,34.444107846107244
2004,AL,F,17138,2220,19358,11.468126872610807
2004,AL,M,16625,7053,23678,29.78714418447504
2004,AR,F,10780,1234,12014,10.271350091559848
2004,AR,M,10840,4290,15130,28.354263053536023
2004,AZ,F,31947,2388,34335,6.955002184359982
2004,AZ,M,29799,11694,41493,28.18306702335334
2004,CA,F,213673,14968,228641,6.546507406808052
2004,CA,M,180798,72420,253218,28.59986256901168
2004,CO,F,22569,2106,24675,8.534954407294833
2004,CO,M,21335,8505,29840,28.50201072386059
2004,CT,F,12901,1445,14346,10.072494075003485
2004,CT,M,11692,5789,17481,33.11595446484755
2004,DC,F,3092,418,3510,11.908831908831909
2004,DC,M,3088,1581,4669,33.861640608267294
2004,DE,F,2723,354,3077,11.504712382190444
2004,DE,M,2622,1523,4145,36.743063932448734
2004,FL,F,75471,6476,81947,7.902668798125617
2004,FL,M,69066,27041,96107,28.13634802875961
2004,GA,F,45628,4875,50503,9.65289190741144
2004,GA,M,42131,16529,58660,28.17763382202523
2004,HI,F,3355,306,3661,8.358372029500137
2004,HI,M,3391,1720,5111,33.6529054979456
2004,IA,F,12274,1285,13559,9.477100081126927
2004,IA,M,11923,4382,16305,26.875191659000308
2004,ID,F,5873,576,6449,8.931617305008528
2004,ID,M,6367,2348,8715,26.942053930005738
2004,IL,F,62667,5770,68437,8.431111825474524
2004,IL,M,56552,22191,78743,28.18155264594948
2004,IN,F,29368,3086,32454,9.508843285881555
2004,IN,M,28122,10913,39035,27.95696170103753
2004,KS,F,12211,1311,13522,9.69531134447567
2004,KS,M,12127,4563,16690,27.3397243858598
2004,KY,F,16464,3013,19477,15.469528161421165
2004,KY,M,15789,6278,22067,28.449721303303576
2004,LA,F,18812,1971,20783,9.483712649761825
2004,LA,M,19224,6410,25634,25.005851603339313
2004,MA,F,26092,3204,29296,10.936646641179683
2004,MA,M,23003,11229,34232,32.80264080392615
2004,MD,F,22032,2462,24494,10.051441169265942
2004,MD,M,19880,8846,28726,30.79440228364548
2004,ME,F,3929,492,4421,11.128703913141823
2004,ME,M,3891,1807,5698,31.712881712881714
2004,MI,F,43808,4324,48132,8.983628355356105
2004,MI,M,40520,16012,56532,28.323781221255217
2004,MN,F,23669,2554,26223,9.739541623765396
2004,MN,M,21501,8698,30199,28.80227822113315
2004,MO,F,25548,2741,28289,9.689278518151932
2004,MO,M,24544,9559,34103,28.029792100401725
2004,MS,F,10418,1298,11716,11.078866507340388
2004,MS,M,10814,4213,15027,28.03620150395954
2004,MT,F,2499,278,2777,10.010803024846956
2004,MT,M,2911,1152,4063,28.35343342357864
2004,NC,F,39912,4517,44429,10.166782957077585
2004,NC,M,35788,15583,51371,30.334235268926047
2004,ND,F,2220,280,2500,11.200000000000001
2004,ND,M,2452,922,3374,27.32661529342027
2004,NE,F,7590,792,8382,9.448818897637794
2004,NE,M,7643,2990,10633,28.120003761873413
2004,NH,F,4096,583,4679,12.45992733490062
2004,NH,M,3834,1873,5707,32.81934466444717
2004,NJ,F,37802,3795,41597,9.123254080823136
2004,NJ,M,33017,14644,47661,30.72533098340362
2004,NM,F,7556,584,8140,7.174447174447174
2004,NM,M,7292,3663,10955,33.43678685531721
2004,NV,F,9946,845,10791,7.83059957371884
2004,NV,M,9863,4028,13891,28.997192426751134
2004,NY,F,88350,8573,96923,8.845165750131548
2004,NY,M,77343,32863,110206,29.8196105475201
2004,OH,F,51964,5395,57359,9.405673041719695
2004,OH,M,47767,19349,67116,28.82919125096847
2004,OK,F,15417,1390,16807,8.270363539001606
2004,OK,M,15095,5691,20786,27.379005099586262
2004,OR,F,14468,1419,15887,8.931831056838925
2004,OR,M,13837,5650,19487,28.993688099758813
2004,PA,F,49702,5614,55316,10.148962325547762
2004,PA,M,44764,19084,63848,29.889738128054127
2004,RI,F,3504,427,3931,10.86237598575426
2004,RI,M,3261,1818,5079,35.7944477259303
2004,SC,F,15234,1878,17112,10.974754558204769
2004,SC,M,14735,6356,21091,30.136076999668106
2004,SD,F,2740,299,3039,9.838762750904904
2004,SD,M,3111,1165,4276,27.245088868101032
2004,TN,F,27093,3311,30404,10.89001447178003
2004,TN,M,25364,10804,36168,29.8717097987171
2004,TX,F,147904,11273,159177,7.082053311722171
2004,TX,M,129946,49984,179930,27.779692102484297
2004,UT,F,16763,1473,18236,8.077429260802807
2004,UT,M,16302,5784,22086,26.18853572398805
2004,VA,F,33322,3649,36971,9.869898028184252
2004,VA,M,29893,13080,42973,30.437716705838554
2004,VT,F,1376,216,1592,13.5678391959799
2004,VT,M,1534,762,2296,33.18815331010453
2004,WA,F,26182,2576,28758,8.957507476180542
2004,WA,M,24910,9826,34736,28.28765545831414
2004,WI,F,22277,2445,24722,9.889976539114958
2004,WI,M,21336,8152,29488,27.64514378730331
2004,WV,F,6374,787,7161,10.990085183633571
2004,WV,M,6135,2853,8988,31.74232309746328
2004,WY,F,1133,134,1267,10.576164167324388
2004,WY,M,1296,532,1828,29.10284463894967
2005,AK,F,2043,252,2295,10.980392156862745
2005,AK,M,2211,1137,3348,33.96057347670251
2005,AL,F,17421,2284,19705,11.590966759705658
2005,AL,M,16897,7007,23904,29.31308567603748
2005,AR,F,11085,1195,12280,9.731270358306189
2005,AR,M,11067,4139,15206,27.219518611074577
2005,AZ,F,33012,2379,35391,6.722047978299568
2005,AZ,M,30448,12164,42612,28.545949497794048
2005,CA,F,215242,14981,230223,6.507169136011607
2005,CA,M,182520,73039,255559,28.580093050919746
2005,CO,F,22575,2126,24701,8.606938990324279
2005,CO,M,21674,8561,30235,28.31486687613693
2005,CT,F,12734,1498,14232,10.52557616638561
2005,CT,M,11382,5549,16931,32.77420116945248
2005,DC,F,2743,389,3132,12.420178799489143
2005,DC,M,2875,1542,4417,34.91057278695948
2005,DE,F,2713,386,3099,12.455630848660858
2005,DE,M,2574,1514,4088,37.03522504892368
2005,FL,F,78882,6739,85621,7.870732647364548
2005,FL,M,72005,27608,99613,27.715258048648266
2005,GA,F,46455,4871,51326,9.490316798503683
2005,GA,M,43579,16526,60105,27.495216704101153
2005,HI,F,3045,268,3313,8.089345004527619
2005,HI,M,3217,1643,4860,33.806584362139915
2005,IA,F,12387,1265,13652,9.26604160562555
2005,IA,M,12276,4297,16573,25.927713751282205
2005,ID,F,6244,600,6844,8.766803039158386
2005,ID,M,6370,2288,8658,26.426426426426424
2005,IL,F,61486,5618,67104,8.37207916070577
2005,IL,M,56039,21544,77583,27.76897000631582
2005,IN,F,29244,3195,32439,9.849255525756034
2005,IN,M,27778,10827,38605,28.04558994948841
2005,KS,F,12518,1215,13733,8.847302118983471
2005,KS,M,12107,4435,16542,26.81054286059727
2005,KY,F,17531,2117,19648,10.774633550488598
2005,KY,M,16513,7134,23647,30.168731763014335
2005,LA,F,17782,1881,19663,9.566190306667345
2005,LA,M,18214,6077,24291,25.017496192005268
2005,MA,F,25359,3125,28484,10.971071478724898
2005,MA,M,22429,10650,33079,32.1956528311013
2005,MD,F,22248,2509,24757,10.134507412045078
2005,MD,M,20119,8892,29011,30.65044293543828
2005,ME,F,3845,544,4389,12.39462292093871
2005,ME,M,3907,1735,5642,30.75150655795817
2005,MI,F,42819,4448,47267,9.41037087185563
2005,MI,M,39786,15366,55152,27.86118363794604
2005,MN,F,23271,2708,25979,10.42380384156434
2005,MN,M,21855,8412,30267,27.792645455446525
2005,MO,F,26083,2826,28909,9.775502438686914
2005,MO,M,25039,9187,34226,26.8421667737977
2005,MS,F,10295,1266,11561,10.950609808840065
2005,MS,M,10832,4023,14855,27.081790642881188
2005,MT,F,2544,277,2821,9.819213045019497
2005,MT,M,2810,1152,3962,29.07622412922766
2005,NC,F,40747,4630,45377,10.203407012363092
2005,NC,M,37283,15468,52751,29.322666868874524
2005,ND,F,2119,298,2417,12.329333884981382
2005,ND,M,2590,982,3572,27.491601343784993
2005,NE,F,7524,756,8280,9.130434782608695
2005,NE,M,7594,2816,10410,27.050912584053794
2005,NH,F,3846,577,4423,13.045444268595977
2005,NH,M,3895,1761,5656,31.135077793493636
2005,NJ,F,36680,3895,40575,9.59950708564387
2005,NJ,M,32841,14290,47131,30.319747087903927
2005,NM,F,7711,604,8315,7.263980757666867
2005,NM,M,7296,3685,10981,33.557963755577816
2005,NV,F,10662,916,11578,7.911556400069096
2005,NV,M,10520,4231,14751,28.682801166022642
2005,NY,F,86431,8538,94969,8.990302098579535
2005,NY,M,76922,31857,108779,29.285983507846186
2005,OH,F,51631,5498,57129,9.623833779691575
2005,OH,M,47423,18597,66020,28.16873674644047
2005,OK,F,15179,1461,16640,8.780048076923077
2005,OK,M,15263,5514,20777,26.53896135149444
2005,OR,F,14386,1493,15879,9.402355312047359
2005,OR,M,14048,5568,19616,28.38499184339315
2005,PA,F,49018,5722,54740,10.453050785531603
2005,PA,M,45032,19230,64262,29.92437210170863
2005,RI,F,3268,480,3748,12.806830309498398
2005,RI,M,3244,1763,5007,35.210705012981826
2005,SC,F,15500,1927,17427,11.05755436965628
2005,SC,M,14930,6436,21366,30.122624730880837
2005,SD,F,2904,311,3215,9.673405909797824
2005,SD,M,3054,1165,4219,27.613178478312395
2005,TN,F,27659,3360,31019,10.832070666365775
2005,TN,M,26271,10833,37104,29.196313065976714
2005,TX,F,148939,11523,160462,7.181139459809799
2005,TX,M,132109,49926,182035,27.42659378690911
2005,UT,F,16721,1648,18369,8.971636997114704
2005,UT,M,16737,5779,22516,25.666192929472377
2005,VA,F,33338,3739,37077,10.084418911993959
2005,VA,M,30388,13037,43425,30.02187679907887
2005,VT,F,1363,220,1583,13.897662665824384
2005,VT,M,1486,740,2226,33.24348607367475
2005,WA,F,26727,2595,29322,8.850010231225701
2005,WA,M,25175,9856,35031,28.135080357397733
2005,WI,F,22593,2353,24946,9.432373927683797
2005,WI,M,21518,7947,29465,26.97098252163584
2005,WV,F,6150,698,6848,10.192757009345794
2005,WV,M,6284,2776,9060,30.6401766004415
2005,WY,F,1182,136,1318,10.318664643399089
2005,WY,M,1441,643,2084,30.854126679462574
2006,AK,F,2138,244,2382,10.243492863140219
2006,AK,M,2234,1139,3373,33.768158908983104
2006,AL,F,18119,2236,20355,10.985015966592975
2006,AL,M,18103,7404,25507,29.027325832124518
2006,AR,F,11206,1249,12455,10.028101164191087
2006,AR,M,11511,4238,15749,26.909645056829007
2006,AZ,F,35498,2610,38108,6.848955599874042
2006,AZ,M,32712,12748,45460,28.042234931808185
2006,CA,F,219673,14891,234564,6.348374004536075
2006,CA,M,188418,73533,261951,28.07128050665964
2006,CO,F,23263,2025,25288,8.007750711800062
2006,CO,M,22067,8474,30541,27.74630824138044
2006,CT,F,12249,1490,13739,10.845039668098115
2006,CT,M,11584,5392,16976,31.762488218661638
2006,DC,F,2896,397,3293,12.055876100819921
2006,DC,M,3072,1638,4710,34.77707006369427
2006,DE,F,2797,336,3133,10.724545164379188
2006,DE,M,2616,1368,3984,34.33734939759036
2006,FL,F,81945,7057,89002,7.92903530257747
2006,FL,M,75454,28664,104118,27.53030215716783
2006,GA,F,48826,4948,53774,9.201472830736042
2006,GA,M,45487,17384,62871,27.650268009097996
2006,HI,F,3288,306,3594,8.514190317195327
2006,HI,M,3558,1631,5189,31.4318751204471
2006,IA,F,12632,1406,14038,10.015671748112267
2006,IA,M,12788,4322,17110,25.260081823495035
2006,ID,F,6345,661,7006,9.434770196974023
2006,ID,M,6703,2496,9199,27.13338406348516
2006,IL,F,62405,5677,68082,8.338474192885052
2006,IL,M,56722,20797,77519,26.828261458481144
2006,IN,F,29809,3206,33015,9.710737543540816
2006,IN,M,28435,10661,39096,27.26877429916104
2006,KS,F,12537,1255,13792,9.099477958236658
2006,KS,M,12476,4473,16949,26.390937518437667
2006,KY,F,18198,2074,20272,10.230860299921074
2006,KY,M,17238,6951,24189,28.736202406052335
2006,LA,F,18002,1982,19984,9.917934347477983
2006,LA,M,19179,6175,25354,24.35513134022245
2006,MA,F,25312,3098,28410,10.90461105244632
2006,MA,M,22679,10496,33175,31.638281838733985
2006,MD,F,22747,2390,25137,9.507896725941839
2006,MD,M,21258,9144,30402,30.076968620485495
2006,ME,F,3748,524,4272,12.265917602996254
2006,ME,M,3915,1665,5580,29.838709677419356
2006,MI,F,42803,4247,47050,9.026567481402763
2006,MI,M,39845,14870,54715,27.177190898291144
2006,MN,F,24096,2732,26828,10.18339048755032
2006,MN,M,22744,8374,31118,26.91046982453885
2006,MO,F,26757,2844,29601,9.607783520826999
2006,MO,M,25981,9243,35224,26.24063138769021
2006,MS,F,11120,1365,12485,10.93311974369243
2006,MS,M,11808,4333,16141,26.844681246515083
2006,MT,F,2672,322,2994,10.754843019372078
2006,MT,M,3194,1198,4392,27.27686703096539
2006,NC,F,42377,4695,47072,9.97408225696805
2006,NC,M,38968,16062,55030,29.187715791386516
2006,ND,F,2278,277,2555,10.841487279843443
2006,ND,M,2522,969,3491,27.757089659123462
2006,NE,F,7532,874,8406,10.397335236735666
2006,NE,M,7936,2779,10715,25.93560429304713
2006,NH,F,3929,573,4502,12.727676588183028
2006,NH,M,3820,1706,5526,30.87224031849439
2006,NJ,F,36793,3884,40677,9.54839344101089
2006,NJ,M,33196,14117,47313,29.83746539006193
2006,NM,F,7814,599,8413,7.119933436348508
2006,NM,M,7692,3765,11457,32.86200576067033
2006,NV,F,11561,936,12497,7.489797551412339
2006,NV,M,11286,4439,15725,28.22893481717011
2006,NY,F,87825,8604,96429,8.92262701054662
2006,NY,M,78750,31321,110071,28.45526978041446
2006,OH,F,51743,5419,57162,9.480074175151325
2006,OH,M,48521,18551,67072,27.65833730916031
2006,OK,F,15931,1525,17456,8.736251145737855
2006,OK,M,16089,5582,21671,25.75792533800932
2006,OR,F,15010,1462,16472,8.875667799902866
2006,OR,M,14945,5607,20552,27.28201634877384
2006,PA,F,49660,5593,55253,10.122527283586411
2006,PA,M,45997,19063,65060,29.30064555794651
2006,RI,F,3104,436,3540,12.31638418079096
2006,RI,M,3272,1617,4889,33.07424831253835
2006,SC,F,16974,1956,18930,10.332805071315372
2006,SC,M,16191,6687,22878,29.22895357985838
2006,SD,F,2864,314,3178,9.880427942101951
2006,SD,M,3104,1172,4276,27.408793264733394
2006,TN,F,28256,3459,31715,10.906511114614535
2006,TN,M,26915,10871,37786,28.769914783253057
2006,TX,F,154331,11649,165980,7.018315459693938
2006,TX,M,136843,50711,187554,27.038079699713148
2006,UT,F,17203,1628,18831,8.645318889065901
2006,UT,M,17490,5930,23420,25.320239111870197
2006,VA,F,34041,3798,37839,10.03726314120352
2006,VA,M,31276,13104,44380,29.526813880126184
2006,VT,F,1244,228,1472,15.489130434782608
2006,VT,M,1453,678,2131,31.816048803378692
2006,WA,F,27937,2668,30605,8.717529815389643
2006,WA,M,26630,10004,36634,27.307965278156903
2006,WI,F,22608,2460,25068,9.813307802776448
2006,WI,M,22185,7918,30103,26.303026276450854
2006,WV,F,6241,744,6985,10.651395848246242
2006,WV,M,6067,2790,8857,31.500508072710847
2006,WY,F,1188,139,1327,10.474755086661643
2006,WY,M,1585,621,2206,28.15049864007253
2007,AK,F,2058,275,2333,11.78739819974282
2007,AK,M,2357,1136,3493,32.52218723160607
2007,AL,F,19044,2257,21301,10.595746678559692
2007,AL,M,18221,7069,25290,27.951759588770265
2007,AR,F,11243,1193,12436,9.593116757799935
2007,AR,M,11875,4069,15944,25.520572002007025
2007,AZ,F,35224,2543,37767,6.733391585246379
2007,AZ,M,32941,12509,45450,27.522552255225524
2007,CA,F,221013,15012,236025,6.360343183984747
2007,CA,M,190352,72852,263204,27.67891065485327
2007,CO,F,22805,2029,24834,8.170250463074817
2007,CO,M,21966,8344,30310,27.528868360277137
2007,CT,F,12393,1422,13815,10.29315960912052
2007,CT,M,11482,5257,16739,31.405699265189078
2007,DC,F,2936,366,3302,11.08419139915203
2007,DC,M,3014,1607,4621,34.77602250595109
2007,DE,F,2658,335,2993,11.19278316070832
2007,DE,M,2715,1429,4144,34.48359073359074
2007,FL,F,82088,7080,89168,7.940068185896286
2007,FL,M,76922,27906,104828,26.620750181249285
2007,GA,F,49095,5085,54180,9.385382059800666
2007,GA,M,46369,17146,63515,26.995197984728016
2007,HI,F,3124,291,3415,8.521229868228405
2007,HI,M,3454,1554,5008,31.030351437699682
2007,IA,F,12582,1305,13887,9.397278029812055
2007,IA,M,12718,4032,16750,24.071641791044776
2007,ID,F,6476,632,7108,8.891389983117614
2007,ID,M,6966,2466,9432,26.14503816793893
2007,IL,F,62141,5489,67630,8.11622061215437
2007,IL,M,57474,20255,77729,26.05848525003538
2007,IN,F,30077,2992,33069,9.047748646768877
2007,IN,M,29223,10329,39552,26.114987864077673
2007,KS,F,12847,1184,14031,8.43845770080536
2007,KS,M,12897,4428,17325,25.558441558441558
2007,KY,F,18407,2024,20431,9.906514610151241
2007,KY,M,17441,6964,24405,28.535136242573245
2007,LA,F,19225,1925,21150,9.101654846335698
2007,LA,M,20020,6130,26150,23.44168260038241
2007,MA,F,24917,2825,27742,10.183115853218947
2007,MA,M,22910,10190,33100,30.785498489425983
2007,MD,F,23245,2427,25672,9.453879713306327
2007,MD,M,21655,8706,30361,28.67494483053918
2007,ME,F,3845,520,4365,11.912943871706757
2007,ME,M,3893,1606,5499,29.205310056373886
2007,MI,F,41406,4161,45567,9.131608400816381
2007,MI,M,39763,14134,53897,26.22409410542331
2007,MN,F,24273,2499,26772,9.334379202151503
2007,MN,M,22664,8047,30711,26.202337924522155
2007,MO,F,26912,2622,29534,8.877903433331076
2007,MO,M,26146,9139,35285,25.90052430211138
2007,MS,F,11376,1346,12722,10.580097468951424
2007,MS,M,12306,4270,16576,25.760135135135137
2007,MT,F,2565,285,2850,10.0
2007,MT,M,3049,1145,4194,27.30090605627086
2007,NC,F,43355,4713,48068,9.804859781975535
2007,NC,M,40820,15911,56731,28.04639438754825
2007,ND,F,2306,282,2588,10.896445131375579
2007,ND,M,2636,922,3558,25.913434513771783
2007,NE,F,7602,756,8358,9.045226130653267
2007,NE,M,8038,2711,10749,25.22095078611964
2007,NH,F,3764,542,4306,12.587087784486764
2007,NH,M,3907,1623,5530,29.349005424954793
2007,NJ,F,37415,3773,41188,9.16043507817811
2007,NJ,M,33308,13794,47102,29.28538066324148
2007,NM,F,7884,635,8519,7.453926517196854
2007,NM,M,7816,3759,11575,32.475161987041034
2007,NV,F,11749,964,12713,7.582789270825139
2007,NV,M,11639,4470,16109,27.748463591780993
2007,NY,F,88898,8754,97652,8.964486134436571
2007,NY,M,80062,31328,111390,28.124607235838045
2007,OH,F,51894,5299,57193,9.265119857325198
2007,OH,M,48969,17245,66214,26.044341075905397
2007,OK,F,16253,1507,17760,8.48536036036036
2007,OK,M,16348,5581,21929,25.45031693191664
2007,OR,F,15300,1442,16742,8.613068928443436
2007,OR,M,15128,5512,20640,26.705426356589147
2007,PA,F,50347,5712,56059,10.189264881642556
2007,PA,M,46709,18539,65248,28.41313143697891
2007,RI,F,3029,419,3448,12.15197215777262
2007,RI,M,3138,1676,4814,34.81512255920233
2007,SC,F,17011,1912,18923,10.104106114252497
2007,SC,M,16460,6722,23182,28.99663532050729
2007,SD,F,2917,332,3249,10.218528778085565
2007,SD,M,3234,1104,4338,25.44951590594744
2007,TN,F,29196,3255,32451,10.030507534436534
2007,TN,M,27967,10963,38930,28.16080143847932
2007,TX,F,157263,11717,168980,6.933956681264054
2007,TX,M,140680,50858,191538,26.55243345967902
2007,UT,F,17893,1681,19574,8.587922754674567
2007,UT,M,18022,5906,23928,24.682380474757608
2007,VA,F,34793,3649,38442,9.492222048800791
2007,VA,M,31878,12834,44712,28.703703703703702
2007,VT,F,1338,217,1555,13.95498392282958
2007,VT,M,1423,628,2051,30.619210141394444
2007,WA,F,28603,2665,31268,8.52309069975694
2007,WA,M,27457,10015,37472,26.72662254483348
2007,WI,F,23026,2358,25384,9.28931610463284
2007,WI,M,22445,7613,30058,25.327699780424513
2007,WV,F,6249,743,6992,10.626430205949656
2007,WV,M,6418,2686,9104,29.50351493848858
2007,WY,F,1325,167,1492,11.193029490616622
2007,WY,M,1519,628,2147,29.250116441546343
2008,AK,F,2146,279,2425,11.505154639175258
2008,AK,M,2360,1191,3551,33.53984793016052
2008,AL,F,18764,2176,20940,10.391595033428844
2008,AL,M,18283,7016,25299,27.732321435629864
2008,AR,F,11067,1111,12178,9.123008704220725
2008,AR,M,11339,3991,15330,26.033920417482058
2008,AZ,F,33805,2515,36320,6.924559471365639
2008,AZ,M,31883,11623,43506,26.715855284328597
2008,CA,F,214450,14659,229109,6.398264581487415
2008,CA,M,185824,69968,255792,27.353474698192283
2008,CO,F,22471,1984,24455,8.112860355755469
2008,CO,M,21966,7956,29922,26.58913174253058
2008,CT,F,11743,1264,13007,9.71784423771815
2008,CT,M,11416,4869,16285,29.898679766656432
2008,DC,F,2847,348,3195,10.892018779342722
2008,DC,M,2856,1411,4267,33.067729083665334
2008,DE,F,2515,369,2884,12.794729542302358
2008,DE,M,2637,1356,3993,33.959429000751314
2008,FL,F,79483,6491,85974,7.549956963733222
2008,FL,M,74316,26807,101123,26.509300554769933
2008,GA,F,48053,4692,52745,8.895629917527728
2008,GA,M,45588,16010,61598,25.991103607259973
2008,HI,F,3211,327,3538,9.242509892594686
2008,HI,M,3538,1546,5084,30.409126671911878
2008,IA,F,12287,1187,13474,8.8095591509574
2008,IA,M,12855,3757,16612,22.616181073922466
2008,ID,F,6812,546,7358,7.420494699646643
2008,ID,M,6990,2269,9259,24.505886164812615
2008,IL,F,61040,5097,66137,7.70672996960854
2008,IL,M,56048,19149,75197,25.465111640092026
2008,IN,F,29675,2751,32426,8.483932646641584
2008,IN,M,28638,9968,38606,25.819820753250788
2008,KS,F,12609,1183,13792,8.577436194895592
2008,KS,M,12739,4280,17019,25.148363593630645
2008,KY,F,18310,1848,20158,9.167576148427424
2008,KY,M,17243,6556,23799,27.54737594016555
2008,LA,F,18465,1744,20209,8.62981839774358
2008,LA,M,19568,5777,25345,22.793450384691262
2008,MA,F,24534,2664,27198,9.794837855724687
2008,MA,M,22636,9644,32280,29.87608426270136
2008,MD,F,22907,2354,25261,9.318712640038003
2008,MD,M,21657,8517,30174,28.22628753231259
2008,ME,F,3667,450,4117,10.930289045421423
2008,ME,M,3649,1520,5169,29.406074675952798
2008,MI,F,40608,3740,44348,8.433300261567602
2008,MI,M,38638,13076,51714,25.285222570290443
2008,MN,F,23342,2375,25717,9.235136291169265
2008,MN,M,22836,7275,30111,24.160605758692835
2008,MO,F,26800,2479,29279,8.466819221967963
2008,MO,M,26182,8546,34728,24.608385164708594
2008,MS,F,11215,1254,12469,10.056941214211244
2008,MS,M,11847,3972,15819,25.10904608382325
2008,MT,F,2749,289,3038,9.512837393021725
2008,MT,M,3171,1083,4254,25.458392101551482
2008,NC,F,43714,4320,48034,8.993629512428697
2008,NC,M,40778,15441,56219,27.46580337608282
2008,ND,F,2435,263,2698,9.747961452928095
2008,ND,M,2699,819,3518,23.2802728823195
2008,NE,F,7606,692,8298,8.33935888165823
2008,NE,M,7868,2557,10425,24.52757793764988
2008,NH,F,3744,504,4248,11.864406779661017
2008,NH,M,3757,1586,5343,29.683698296836987
2008,NJ,F,35701,3576,39277,9.104565012602796
2008,NJ,M,32840,13016,45856,28.384508025122123
2008,NM,F,7857,609,8466,7.193479801559177
2008,NM,M,7707,3572,11279,31.66947424417058
2008,NV,F,11226,909,12135,7.490729295426453
2008,NV,M,11073,4105,15178,27.045724074318088
2008,NY,F,87040,8397,95437,8.79847438624433
2008,NY,M,79793,30001,109794,27.324808277319345
2008,OH,F,51471,4758,56229,8.461825748279358
2008,OH,M,48441,16472,64913,25.375502595782045
2008,OK,F,16052,1306,17358,7.523908284364558
2008,OK,M,16277,5275,21552,24.475686711210095
2008,OR,F,15199,1373,16572,8.285059135891865
2008,OR,M,15069,5219,20288,25.724566246056785
2008,PA,F,49913,5321,55234,9.633559039721911
2008,PA,M,46634,17746,64380,27.564461012736874
2008,RI,F,2879,359,3238,11.087090796788141
2008,RI,M,3040,1519,4559,33.31871024347445
2008,SC,F,17336,1822,19158,9.510387305564254
2008,SC,M,16681,6527,23208,28.12392278524647
2008,SD,F,2878,250,3128,7.9923273657289
2008,SD,M,3068,1142,4210,27.125890736342047
2008,TN,F,28985,3087,32072,9.625218258917435
2008,TN,M,27777,10204,37981,26.866064611252995
2008,TX,F,156030,11477,167507,6.851653960729999
2008,TX,M,140552,49712,190264,26.127906487827442
2008,UT,F,18153,1567,19720,7.946247464503042
2008,UT,M,18300,5512,23812,23.14799260876869
2008,VA,F,34118,3461,37579,9.209931078527902
2008,VA,M,31102,12252,43354,28.260368132121606
2008,VT,F,1209,191,1400,13.642857142857142
2008,VT,M,1386,597,1983,30.10590015128593
2008,WA,F,29432,2668,32100,8.311526479750778
2008,WA,M,27812,9726,37538,25.90974479194416
2008,WI,F,22792,2176,24968,8.715155398910605
2008,WI,M,22519,7036,29555,23.806462527491117
2008,WV,F,6165,679,6844,9.921098772647575
2008,WV,M,6238,2504,8742,28.643331045527336
2008,WY,F,1268,146,1414,10.325318246110324
2008,WY,M,1547,603,2150,28.046511627906977
2009,AK,F,2106,227,2333,9.729961423060438
2009,AK,M,2336,1168,3504,33.33333333333333
2009,AL,F,18005,1968,19973,9.853301957642818
2009,AL,M,17849,6510,24359,26.725235026068393
2009,AR,F,10716,1037,11753,8.823279162766953
2009,AR,M,11307,3815,15122,25.228144425340567
2009,AZ,F,31044,2227,33271,6.693516876559166
2009,AZ,M,29489,10548,40037,26.345630291979923
2009,CA,F,204079,13940,218019,6.393938143005886
2009,CA,M,177747,66130,243877,27.11612821217253
2009,CO,F,21963,1830,23793,7.691337788425168
2009,CO,M,21508,7498,29006,25.849824174308765
2009,CT,F,11362,1246,12608,9.88261421319797
2009,CT,M,10879,4536,15415,29.425883879338304
2009,DC,F,2672,324,2996,10.814419225634179
2009,DC,M,2876,1412,4288,32.92910447761194
2009,DE,F,2432,305,2737,11.143587869930581
2009,DE,M,2541,1265,3806,33.23699421965318
2009,FL,F,75972,6211,82183,7.557524062153973
2009,FL,M,70746,25347,96093,26.377571727389093
2009,GA,F,46357,4274,50631,8.44146866544212
2009,GA,M,43882,15642,59524,26.27847590887709
2009,HI,F,3091,280,3371,8.306140611094632
2009,HI,M,3198,1483,4681,31.681264687032684
2009,IA,F,12065,1108,13173,8.411144006680331
2009,IA,M,12361,3570,15931,22.409139413721675
2009,ID,F,6194,571,6765,8.440502586844051
2009,ID,M,6670,2167,8837,24.521896571234585
2009,IL,F,58332,4813,63145,7.6221395201520314
2009,IL,M,54781,18247,73028,24.986306622117542
2009,IN,F,28914,2640,31554,8.366609621601064
2009,IN,M,28320,9361,37681,24.84275895013402
2009,KS,F,12555,1159,13714,8.451217733702785
2009,KS,M,12607,4256,16863,25.238688252386883
2009,KY,F,17507,1718,19225,8.93628088426528
2009,KY,M,17169,6473,23642,27.37924033499704
2009,LA,F,18875,1755,20630,8.507028599127485
2009,LA,M,19643,5609,25252,22.212102011721843
2009,MA,F,23729,2497,26226,9.521085945245176
2009,MA,M,22033,9312,31345,29.708087414260646
2009,MD,F,22438,2270,24708,9.187307754573418
2009,MD,M,20949,8101,29050,27.886402753872634
2009,ME,F,3502,441,3943,11.184377377631245
2009,ME,M,3680,1438,5118,28.096912856584606
2009,MI,F,39089,3463,42552,8.13827787178041
2009,MI,M,37296,12414,49710,24.972842486421243
2009,MN,F,22627,2132,24759,8.611010137727696
2009,MN,M,22421,7045,29466,23.908911966334077
2009,MO,F,25543,2313,27856,8.303417576105685
2009,MO,M,25697,7944,33641,23.61404238875182
2009,MS,F,10614,1114,11728,9.498635743519781
2009,MS,M,11326,3700,15026,24.623985092506324
2009,MT,F,2678,266,2944,9.035326086956522
2009,MT,M,3046,994,4040,24.603960396039604
2009,NC,F,42230,4159,46389,8.965487507814354
2009,NC,M,39890,14524,54414,26.691660234498478
2009,ND,F,2350,279,2629,10.612400152149107
2009,ND,M,2538,820,3358,24.419297200714713
2009,NE,F,7501,687,8188,8.390327308255985
2009,NE,M,7963,2520,10483,24.038920156443766
2009,NH,F,3496,430,3926,10.952623535404992
2009,NH,M,3659,1503,5162,29.116621464548626
2009,NJ,F,34862,3436,38298,8.971747871951537
2009,NJ,M,32431,12483,44914,27.793115732288378
2009,NM,F,7400,587,7987,7.349442844622511
2009,NM,M,7362,3339,10701,31.202691337258198
2009,NV,F,10556,870,11426,7.614213197969544
2009,NV,M,10441,4008,14449,27.738943871548205
2009,NY,F,86556,8094,94650,8.551505546751189
2009,NY,M,79142,29277,108419,27.003569485053358
2009,OH,F,49748,4532,54280,8.349299926308031
2009,OH,M,47254,16010,63264,25.306651492159837
2009,OK,F,15840,1268,17108,7.411737198971241
2009,OK,M,16410,5180,21590,23.99258916164891
2009,OR,F,14348,1265,15613,8.102222506885289
2009,OR,M,14485,4999,19484,25.656949291726544
2009,PA,F,49493,4993,54486,9.163821899203466
2009,PA,M,45622,17041,62663,27.194676284250676
2009,RI,F,2727,329,3056,10.765706806282722
2009,RI,M,2842,1432,4274,33.504913430042116
2009,SC,F,16749,1781,18530,9.611440906637885
2009,SC,M,15787,6112,21899,27.909950226037715
2009,SD,F,2726,293,3019,9.70520039748261
2009,SD,M,3113,1067,4180,25.526315789473685
2009,TN,F,27658,2759,30417,9.07058552782983
2009,TN,M,26914,9698,36612,26.488582978258496
2009,TX,F,155540,10860,166400,6.526442307692308
2009,TX,M,138944,48721,187665,25.961687048730454
2009,UT,F,17543,1451,18994,7.639254501421501
2009,UT,M,17968,5109,23077,22.13892620357932
2009,VA,F,33264,3390,36654,9.2486495334752
2009,VA,M,30535,12072,42607,28.3333724505363
2009,VT,F,1106,162,1268,12.77602523659306
2009,VT,M,1400,562,1962,28.644240570846076
2009,WA,F,28820,2506,31326,7.99974462108153
2009,WA,M,27640,9595,37235,25.76876594601853
2009,WI,F,22472,1962,24434,8.029794548579847
2009,WI,M,21915,7025,28940,24.274360746371805
2009,WV,F,6136,583,6719,8.676886441434737
2009,WV,M,6263,2390,8653,27.620478446781465
2009,WY,F,1172,126,1298,9.70724191063174
2009,WY,M,1512,578,2090,27.6555023923445
2010,AK,F,2177,230,2407,9.555463232239301
2010,AK,M,2378,1080,3458,31.231925968768078
2010,AL,F,17035,1843,18878,9.762686725288695
2010,AL,M,17501,6071,23572,25.755133208891905
2010,AR,F,10324,954,11278,8.458946621741443
2010,AR,M,10913,3566,14479,24.628772705297326
2010,AZ,F,29261,2069,31330,6.603894031279924
2010,AZ,M,27283,10060,37343,26.93945317730231
2010,CA,F,197351,13305,210656,6.315984353638158
2010,CA,M,172039,63460,235499,26.94703586851749
2010,CO,F,21055,1745,22800,7.6535087719298245
2010,CO,M,20602,7130,27732,25.7103706908986
2010,CT,F,11066,1121,12187,9.198326085172726
2010,CT,M,10436,4408,14844,29.69549986526543
2010,DC,F,2652,317,2969,10.676995621421353
2010,DC,M,2664,1283,3947,32.50570053204966
2010,DE,F,2372,293,2665,10.99437148217636
2010,DE,M,2486,1173,3659,32.05793932768516
2010,FL,F,73672,5746,79418,7.235135611574202
2010,FL,M,68882,24393,93275,26.151701956580002
2010,GA,F,43830,4009,47839,8.38019189364326
2010,GA,M,41838,14432,56270,25.647769681890882
2010,HI,F,2965,259,3224,8.03349875930521
2010,HI,M,3334,1554,4888,31.79214402618658
2010,IA,F,11728,1064,12792,8.317698561601
2010,IA,M,11939,3463,15402,22.48409297493832
2010,ID,F,5833,533,6366,8.372604461200126
2010,ID,M,6358,2098,8456,24.810785241248816
2010,IL,F,56172,4528,60700,7.4596375617792425
2010,IL,M,52771,17537,70308,24.94310746998919
2010,IN,F,27703,2484,30187,8.228707721867028
2010,IN,M,27508,8914,36422,24.474218878699688
2010,KS,F,12213,1091,13304,8.200541190619361
2010,KS,M,12428,4035,16463,24.50950616534046
2010,KY,F,16750,1545,18295,8.44493030882755
2010,KY,M,16817,5845,22662,25.792074838937427
2010,LA,F,18089,1561,19650,7.9440203562340965
2010,LA,M,18651,5383,24034,22.397436964300574
2010,MA,F,23217,2320,25537,9.08485726592787
2010,MA,M,21448,8855,30303,29.22152922152922
2010,MD,F,22055,2270,24325,9.331963001027749
2010,MD,M,20473,8039,28512,28.195145903479236
2010,ME,F,3477,363,3840,9.453125
2010,ME,M,3514,1301,4815,27.01973001038422
2010,MI,F,38152,3261,41413,7.874338975683965
2010,MI,M,36612,11902,48514,24.533124458919076
2010,MN,F,22096,2125,24221,8.773378473225714
2010,MN,M,21394,6529,27923,23.382158077570462
2010,MO,F,25013,2182,27195,8.023533737819452
2010,MO,M,24966,7871,32837,23.96991198952401
2010,MS,F,10011,958,10969,8.733704075120794
2010,MS,M,10493,3399,13892,24.467319320472214
2010,MT,F,2629,254,2883,8.810267082899758
2010,MT,M,2922,1009,3931,25.667769015517678
2010,NC,F,41022,3867,44889,8.61458263717169
2010,NC,M,38038,14005,52043,26.910439444305673
2010,ND,F,2470,214,2684,7.973174366616989
2010,ND,M,2750,833,3583,23.24867429528328
2010,NE,F,7206,656,7862,8.343932841516153
2010,NE,M,7612,2318,9930,23.34340382678751
2010,NH,F,3499,388,3887,9.981991252894263
2010,NH,M,3651,1416,5067,27.945529899348724
2010,NJ,F,34011,3184,37195,8.560290361607743
2010,NJ,M,30997,12084,43081,28.04948817344073
2010,NM,F,6854,572,7426,7.702666307568004
2010,NM,M,7031,3092,10123,30.544305047910697
2010,NV,F,10099,761,10860,7.007366482504604
2010,NV,M,10096,3649,13745,26.5478355765733
2010,NY,F,84971,7920,92891,8.526122013973367
2010,NY,M,78251,28703,106954,26.83677094825813
2010,OH,F,47393,4168,51561,8.083629099513198
2010,OH,M,46255,14734,60989,24.158454803325192
2010,OK,F,15651,1181,16832,7.016397338403042
2010,OK,M,15848,4845,20693,23.413714782776786
2010,OR,F,13889,1154,15043,7.671342152496178
2010,OR,M,13638,4845,18483,26.21327706541146
2010,PA,F,48247,4513,52760,8.553828658074298
2010,PA,M,45104,16360,61464,26.617206820252505
2010,RI,F,2666,321,2987,10.746568463341145
2010,RI,M,2769,1307,4076,32.0657507360157
2010,SC,F,16068,1561,17629,8.854728004991774
2010,SC,M,15470,5753,21223,27.107383499034064
2010,SD,F,2748,266,3014,8.825481088254811
2010,SD,M,3019,1004,4023,24.95650012428536
2010,TN,F,26577,2595,29172,8.895516248457424
2010,TN,M,26159,9232,35391,26.08572800994603
2010,TX,F,148928,10396,159324,6.525068414049359
2010,TX,M,133907,45846,179753,25.504998525754786
2010,UT,F,16747,1364,18111,7.531334548064712
2010,UT,M,17163,4990,22153,22.52516589175281
2010,VA,F,32367,3254,35621,9.135060778754106
2010,VA,M,30275,11659,41934,27.803214575284972
2010,VT,F,1100,145,1245,11.646586345381527
2010,VT,M,1404,469,1873,25.040042712226374
2010,WA,F,27936,2347,30283,7.7502228973351395
2010,WA,M,26727,9158,35885,25.52041242859133
2010,WI,F,21585,1813,23398,7.748525515001282
2010,WI,M,21607,6338,27945,22.68026480586867
2010,WV,F,5941,597,6538,9.131232792903027
2010,WV,M,5888,2230,8118,27.469820152746983
2010,WY,F,1141,124,1265,9.802371541501977
2010,WY,M,1368,554,1922,28.82414151925078
2011,AK,F,2257,258,2515,10.25844930417495
2011,AK,M,2408,1021,3429,29.775444736074657
2011,AL,F,16886,1749,18635,9.385564797424202
2011,AL,M,17194,5903,23097,25.55743170108672
2011,AR,F,10518,913,11431,7.987052751290351
2011,AR,M,11081,3494,14575,23.972555746140653
2011,AZ,F,28276,1962,30238,6.488524373305113
2011,AZ,M,27137,9564,36701,26.059235443175936
2011,CA,F,194272,12893,207165,6.223541621412884
2011,CA,M,169727,62294,232021,26.84843182298154
2011,CO,F,20717,1628,22345,7.285746251957932
2011,CO,M,20397,6893,27290,25.258336386954927
2011,CT,F,11037,1005,12042,8.345789735924265
2011,CT,M,10487,4294,14781,29.05080847033354
2011,DC,F,2599,333,2932,11.357435197817189
2011,DC,M,2749,1328,4077,32.57297032131469
2011,DE,F,2433,314,2747,11.430651619949035
2011,DE,M,2488,1198,3686,32.50135648399349
2011,FL,F,73633,5662,79295,7.140424995270823
2011,FL,M,68665,24083,92748,25.966058567300642
2011,GA,F,43777,3806,47583,7.998654981821239
2011,GA,M,41496,13780,55276,24.929444967074318
2011,HI,F,3076,273,3349,8.151687070767395
2011,HI,M,3464,1432,4896,29.248366013071898
2011,IA,F,11407,978,12385,7.896649172385952
2011,IA,M,11904,3205,15109,21.21252233767953
2011,ID,F,5695,426,6121,6.959647116484234
2011,ID,M,6313,1881,8194,22.95582133268245
2011,IL,F,55278,4062,59340,6.8452982810920115
2011,IL,M,51341,17012,68353,24.888446739718812
2011,IN,F,27848,2329,30177,7.717798323226297
2011,IN,M,27658,8571,36229,23.657843164315878
2011,KS,F,11673,968,12641,7.657622023574085
2011,KS,M,12221,3813,16034,23.78071597854559
2011,KY,F,16769,1507,18276,8.245786824250382
2011,KY,M,16779,5545,22324,24.838738577315894
2011,LA,F,18000,1472,19472,7.559572719802794
2011,LA,M,18645,5245,23890,21.954792800334868
2011,MA,F,23300,2194,25494,8.605946497215031
2011,MA,M,21642,8652,30294,28.56011091305209
2011,MD,F,21826,2125,23951,8.872280906851488
2011,MD,M,20556,7726,28282,27.317728590623013
2011,ME,F,3306,337,3643,9.25061762283832
2011,ME,M,3593,1229,4822,25.487349647449193
2011,MI,F,38174,3002,41176,7.290654750340003
2011,MI,M,37008,11541,48549,23.77185935858617
2011,MN,F,21961,1876,23837,7.870117883961908
2011,MN,M,21807,6583,28390,23.187742162733358
2011,MO,F,24856,2057,26913,7.643146434808457
2011,MO,M,25111,7426,32537,22.823247379905954
2011,MS,F,10140,962,11102,8.665105386416862
2011,MS,M,10628,3349,13977,23.960792730915077
2011,MT,F,2612,207,2819,7.343029443064916
2011,MT,M,2896,941,3837,24.524367995830076
2011,NC,F,40365,3735,44100,8.46938775510204
2011,NC,M,38057,13305,51362,25.904365094817177
2011,ND,F,2429,265,2694,9.836674090571641
2011,ND,M,2739,847,3586,23.619631901840492
2011,NE,F,7172,582,7754,7.5058034562806295
2011,NE,M,7694,2154,9848,21.872461413484974
2011,NH,F,3578,358,3936,9.095528455284553
2011,NH,M,3595,1365,4960,27.52016129032258
2011,NJ,F,33893,3033,36926,8.213724746790879
2011,NJ,M,30902,11824,42726,27.674015821747883
2011,NM,F,6783,499,7282,6.85251304586652
2011,NM,M,6578,3055,9633,31.713900134952766
2011,NV,F,9674,775,10449,7.416977701215427
2011,NV,M,9806,3667,13473,27.217397758479922
2011,NY,F,85001,7564,92565,8.171555123426781
2011,NY,M,77422,27664,105086,26.325105151970767
2011,OH,F,47376,4000,51376,7.785736530675802
2011,OH,M,45626,14458,60084,24.062978496771187
2011,OK,F,15160,1118,16278,6.868165622312324
2011,OK,M,15633,4785,20418,23.435204231560387
2011,OR,F,13729,1080,14809,7.292862448511041
2011,OR,M,13586,4741,18327,25.86893654171441
2011,PA,F,48161,4504,52665,8.552169372448496
2011,PA,M,45327,16000,61327,26.08965056174279
2011,RI,F,2629,281,2910,9.656357388316152
2011,RI,M,2772,1296,4068,31.858407079646017
2011,SC,F,15935,1477,17412,8.482655639788652
2011,SC,M,15617,5600,21217,26.393929396238864
2011,SD,F,2754,271,3025,8.958677685950413
2011,SD,M,3094,917,4011,22.862129144851657
2011,TN,F,26987,2452,29439,8.329087265192433
2011,TN,M,26127,8881,35008,25.368487202925046
2011,TX,F,145351,10116,155467,6.506847112248902
2011,TX,M,131689,44429,176118,25.226836552765757
2011,UT,F,16598,1293,17891,7.22709742328545
2011,UT,M,16660,4822,21482,22.446699562424357
2011,VA,F,32918,3072,35990,8.535704362322868
2011,VA,M,30173,11537,41710,27.660033565092302
2011,VT,F,1149,134,1283,10.44427123928293
2011,VT,M,1299,469,1768,26.52714932126697
2011,WA,F,27908,2241,30149,7.433082357623802
2011,WA,M,27144,9041,36185,24.985491225645987
2011,WI,F,21606,1724,23330,7.389627089584226
2011,WI,M,21275,6235,27510,22.66448564158488
2011,WV,F,6006,486,6492,7.486136783733826
2011,WV,M,6354,2159,8513,25.36121226359685
2011,WY,F,1046,96,1142,8.40630472854641
2011,WY,M,1349,521,1870,27.860962566844922
2012,AK,F,2057,233,2290,10.174672489082969
2012,AK,M,2365,1017,3382,30.070963926670608
2012,AL,F,16794,1606,18400,8.728260869565217
2012,AL,M,16701,5639,22340,25.241718889883618
2012,AR,F,10473,840,11313,7.425086184036064
2012,AR,M,10927,3357,14284,23.50182021842621
2012,AZ,F,28678,1929,30607,6.302479824876663
2012,AZ,M,27352,9625,36977,26.029694134191523
2012,CA,F,195130,13295,208425,6.378793330934389
2012,CA,M,170769,61496,232265,26.476653822142808
2012,CO,F,20735,1601,22336,7.167800859598854
2012,CO,M,20547,6786,27333,24.827132038195586
2012,CT,F,10662,997,11659,8.551333733596362
2012,CT,M,10302,4188,14490,28.902691511387165
2012,DC,F,2866,315,3181,9.90254636906633
2012,DC,M,2820,1353,4173,32.42271746944645
2012,DE,F,2427,206,2633,7.823775161412836
2012,DE,M,2434,1141,3575,31.916083916083913
2012,FL,F,73811,5515,79326,6.95232332400474
2012,FL,M,68812,23805,92617,25.702624788105854
2012,GA,F,43372,3758,47130,7.973689794186294
2012,GA,M,40689,13631,54320,25.093888070692195
2012,HI,F,3088,290,3378,8.584961515689757
2012,HI,M,3323,1411,4734,29.805661174482466
2012,IA,F,11549,898,12447,7.214589861010685
2012,IA,M,12057,3112,15169,20.515525084053003
2012,ID,F,5856,490,6346,7.721399306649858
2012,ID,M,6261,1878,8139,23.074087725764837
2012,IL,F,54635,3948,58583,6.739156410562791
2012,IL,M,50708,16363,67071,24.396535015133217
2012,IN,F,27615,2271,29886,7.598875727765508
2012,IN,M,27381,8502,35883,23.693671097734303
2012,KS,F,12095,978,13073,7.481067849766694
2012,KS,M,12386,3783,16169,23.396623167790214
2012,KY,F,16561,1472,18033,8.162812621305385
2012,KY,M,16876,5400,22276,24.241335966959955
2012,LA,F,18194,1449,19643,7.376673624191824
2012,LA,M,19095,5242,24337,21.53922011751654
2012,MA,F,23189,2179,25368,8.58956165247556
2012,MA,M,21451,8490,29941,28.35576634046959
2012,MD,F,21943,2121,24064,8.813996010638297
2012,MD,M,20383,7623,28006,27.219167321288296
2012,ME,F,3263,377,3640,10.357142857142858
2012,ME,M,3570,1229,4799,25.60950197957908
2012,MI,F,37942,2951,40893,7.216394003863742
2012,MI,M,36485,11357,47842,23.73855608043142
2012,MN,F,22120,1836,23956,7.664050759726164
2012,MN,M,21697,6183,27880,22.17718794835007
2012,MO,F,24846,1888,26734,7.062168025735019
2012,MO,M,24610,7269,31879,22.801844474418896
2012,MS,F,9686,892,10578,8.432595953866516
2012,MS,M,10392,3144,13536,23.22695035460993
2012,MT,F,2479,249,2728,9.127565982404692
2012,MT,M,2928,994,3922,25.344212136664968
2012,NC,F,40311,3557,43868,8.1084161575636
2012,NC,M,38135,12822,50957,25.162391820554586
2012,ND,F,2567,226,2793,8.091657715717867
2012,ND,M,2993,888,3881,22.880700850296314
2012,NE,F,7195,509,7704,6.606957424714434
2012,NE,M,7692,2265,9957,22.747815607110574
2012,NH,F,3350,342,3692,9.263271939328277
2012,NH,M,3433,1354,4787,28.28493837476499
2012,NJ,F,33482,2961,36443,8.125017150069972
2012,NJ,M,30242,11517,41759,27.579683421537872
2012,NM,F,6514,543,7057,7.694487742666856
2012,NM,M,6751,3029,9780,30.971370143149286
2012,NV,F,9546,710,10256,6.922776911076443
2012,NV,M,9883,3467,13350,25.97003745318352
2012,NY,F,84607,7453,92060,8.095807082337606
2012,NY,M,77624,27381,105005,26.0759011475644
2012,OH,F,47505,3816,51321,7.435552697726076
2012,OH,M,46147,13953,60100,23.21630615640599
2012,OK,F,15286,1038,16324,6.358735604018623
2012,OK,M,15672,4621,20293,22.77139900458286
2012,OR,F,13734,1067,14801,7.208972366731977
2012,OR,M,13802,4372,18174,24.056344228018048
2012,PA,F,48155,4355,52510,8.293658350790325
2012,PA,M,45081,15604,60685,25.713108675949574
2012,RI,F,2682,280,2962,9.453072248480757
2012,RI,M,2745,1241,3986,31.13396889111892
2012,SC,F,15897,1455,17352,8.385200553250344
2012,SC,M,15658,5395,21053,25.625801548472904
2012,SD,F,2738,235,2973,7.904473595694585
2012,SD,M,3100,1021,4121,24.775539917495752
2012,TN,F,27233,2458,29691,8.27860294365296
2012,TN,M,27217,8656,35873,24.12956819892398
2012,TX,F,147746,10016,157762,6.348803894473955
2012,TX,M,133902,44806,178708,25.072184793070264
2012,UT,F,16526,1288,17814,7.230268328281126
2012,UT,M,17258,4427,21685,20.415033433248787
2012,VA,F,33247,3047,36294,8.395327051303246
2012,VA,M,30909,11273,42182,26.72466929021858
2012,VT,F,1039,125,1164,10.738831615120274
2012,VT,M,1325,487,1812,26.876379690949225
2012,WA,F,28229,2140,30369,7.046659422437354
2012,WA,M,27235,8907,36142,24.64445797133529
2012,WI,F,21350,1572,22922,6.85804031061862
2012,WI,M,21316,6137,27453,22.354569628091646
2012,WV,F,6032,498,6530,7.626339969372128
2012,WV,M,6306,2052,8358,24.55132806891601
2012,WY,F,1028,117,1145,10.218340611353712
2012,WY,M,1416,515,1931,26.67011910926981
2013,AK,F,2199,227,2426,9.356966199505358
2013,AK,M,2518,994,3512,28.302961275626426
2013,AL,F,16954,1639,18593,8.815145484859894
2013,AL,M,17024,5486,22510,24.371390493114173
2013,AR,F,10260,904,11164,8.097456108921532
2013,AR,M,10851,3398,14249,23.8472875289494
2013,AZ,F,28361,1911,30272,6.312764270613108
2013,AZ,M,27260,9382,36642,25.604497571093283
2013,CA,F,191431,12709,204140,6.2256294699715875
2013,CA,M,168134,60444,228578,26.443489749669695
2013,CO,F,21065,1562,22627,6.9032571706368495
2013,CO,M,20355,6666,27021,24.669701343399577
2013,CT,F,10755,937,11692,8.01402668491276
2013,CT,M,10276,4175,14451,28.890734205245312
2013,DC,F,2999,320,3319,9.641458270563422
2013,DC,M,2971,1372,4343,31.59106608335252
2013,DE,F,2306,252,2558,9.851446442533229
2013,DE,M,2394,1151,3545,32.46826516220028
2013,FL,F,74955,5779,80734,7.158074664949092
2013,FL,M,69603,24369,93972,25.932192567998978
2013,GA,F,42757,3565,46322,7.696127110228401
2013,GA,M,40696,13287,53983,24.613304188355595
2013,HI,F,2971,287,3258,8.809085328422345
2013,HI,M,3520,1365,4885,27.942681678607983
2013,IA,F,11744,884,12628,7.000316756414317
2013,IA,M,12152,3115,15267,20.403484640073362
2013,ID,F,5671,484,6155,7.863525588952071
2013,ID,M,6197,1815,8012,22.65351972041937
2013,IL,F,53911,3804,57715,6.591007537035433
2013,IL,M,50106,16293,66399,24.538020150905886
2013,IN,F,27474,2170,29644,7.320199703143976
2013,IN,M,27360,8465,35825,23.628750872295885
2013,KS,F,11847,958,12805,7.4814525575946895
2013,KS,M,11903,3750,15653,23.957068932473007
2013,KY,F,16931,1402,18333,7.647411771123111
2013,KY,M,16792,5537,22329,24.797348739307626
2013,LA,F,18606,1433,20039,7.151055441888318
2013,LA,M,19488,5344,24832,21.52061855670103
2013,MA,F,23193,2111,25304,8.342554536832122
2013,MA,M,21188,8433,29621,28.46966679045272
2013,MD,F,21429,2045,23474,8.71176620942319
2013,MD,M,20171,7548,27719,27.230419567805477
2013,ME,F,3237,283,3520,8.039772727272727
2013,ME,M,3525,1208,4733,25.522924149588
2013,MI,F,38438,2782,41220,6.749150897622513
2013,MI,M,36910,11158,48068,23.21294832320879
2013,MN,F,22324,1759,24083,7.303907320516546
2013,MN,M,21959,6218,28177,22.067643822976184
2013,MO,F,24894,1913,26807,7.1361957697616285
2013,MO,M,24598,7180,31778,22.594247592674176
2013,MS,F,9955,906,10861,8.341773317374091
2013,MS,M,10339,3220,13559,23.74806401652039
2013,MT,F,2589,212,2801,7.568725455194573
2013,MT,M,3062,991,4053,24.451023932889218
2013,NC,F,40650,3532,44182,7.994205785161378
2013,NC,M,37845,12926,50771,25.459415808236983
2013,ND,F,2920,229,3149,7.272149888853605
2013,ND,M,3012,875,3887,22.51093388217134
2013,NE,F,7291,536,7827,6.8480899450619654
2013,NE,M,7745,2276,10021,22.71230416126135
2013,NH,F,3410,318,3728,8.530042918454935
2013,NH,M,3661,1251,4912,25.468241042345273
2013,NJ,F,33427,3001,36428,8.238168441857912
2013,NJ,M,30460,11385,41845,27.207551678814674
2013,NM,F,6278,445,6723,6.619068868064852
2013,NM,M,6402,2908,9310,31.235230934479052
2013,NV,F,9733,698,10431,6.691592368900393
2013,NV,M,9877,3434,13311,25.798212005108557
2013,NY,F,83726,7209,90935,7.927640622422609
2013,NY,M,76531,26685,103216,25.853549837234535
2013,OH,F,48453,3772,52225,7.222594542843466
2013,OH,M,46079,13803,59882,23.050332320229785
2013,OK,F,15359,1089,16448,6.620865758754864
2013,OK,M,16363,4709,21072,22.347190584662112
2013,OR,F,13871,1108,14979,7.397022498164096
2013,OR,M,13724,4348,18072,24.059318282425853
2013,PA,F,47727,4069,51796,7.855818982160785
2013,PA,M,44684,15437,60121,25.67655228622278
2013,RI,F,2631,253,2884,8.77253814147018
2013,RI,M,2652,1255,3907,32.121832608139236
2013,SC,F,16037,1399,17436,8.023629272768984
2013,SC,M,15853,5518,21371,25.82003649805812
2013,SD,F,2886,251,3137,8.001275103602168
2013,SD,M,3201,970,4171,23.25581395348837
2013,TN,F,27206,2273,29479,7.710573628684826
2013,TN,M,26851,8824,35675,24.734407848633495
2013,TX,F,150099,10103,160202,6.30641315339384
2013,TX,M,135783,45467,181250,25.085241379310347
2013,UT,F,16320,1225,17545,6.982046166999146
2013,UT,M,16960,4652,21612,21.5250786600037
2013,VA,F,33176,2982,36158,8.247137562918303
2013,VA,M,30836,11271,42107,26.767520839765357
2013,VT,F,1121,118,1239,9.523809523809524
2013,VT,M,1381,449,1830,24.535519125683063
2013,WA,F,27611,2076,29687,6.992959881429582
2013,WA,M,27182,8699,35881,24.24402887321981
2013,WI,F,21284,1618,22902,7.0648851628678715
2013,WI,M,21304,5931,27235,21.77712502294841
2013,WV,F,6035,492,6527,7.537919411674583
2013,WV,M,6350,2032,8382,24.242424242424242
2013,WY,F,1149,84,1233,6.81265206812652
2013,WY,M,1444,545,1989,27.40070387129211
2014,AK,F,2308,224,2532,8.846761453396525
2014,AK,M,2394,1081,3475,31.107913669064747
2014,AL,F,17563,1656,19219,8.61647328164837
2014,AL,M,17453,5723,23176,24.69364860200207
2014,AR,F,10600,865,11465,7.544701264718709
2014,AR,M,11138,3365,14503,23.202096118044544
2014,AZ,F,29063,1945,31008,6.272574819401444
2014,AZ,M,27895,9386,37281,25.176363294975996
2014,CA,F,194552,13090,207642,6.304119590448947
2014,CA,M,171111,60661,231772,26.17270420930915
2014,CO,F,21554,1487,23041,6.453712946486697
2014,CO,M,20858,6509,27367,23.78411956005408
2014,CT,F,11032,1003,12035,8.334025758205236
2014,CT,M,10593,4190,14783,28.343367381451667
2014,DC,F,3122,325,3447,9.428488540760082
2014,DC,M,2820,1400,4220,33.175355450236964
2014,DE,F,2515,277,2792,9.921203438395414
2014,DE,M,2551,1062,3613,29.393855521727097
2014,FL,F,77391,5643,83034,6.796011272490787
2014,FL,M,71754,24617,96371,25.543991449709974
2014,GA,F,44099,3722,47821,7.783191484912486
2014,GA,M,41866,13218,55084,23.99607871614262
2014,HI,F,2921,280,3201,8.747266479225242
2014,HI,M,3348,1427,4775,29.884816753926703
2014,IA,F,11887,854,12741,6.702770583156738
2014,IA,M,12508,3225,15733,20.498315642280556
2014,ID,F,5844,474,6318,7.502374169040836
2014,ID,M,6407,1853,8260,22.433414043583536
2014,IL,F,54524,4026,58550,6.876174210076858
2014,IL,M,50714,16106,66820,24.103561807841963
2014,IN,F,28018,2160,30178,7.157531976936841
2014,IN,M,27809,8339,36148,23.069049463317473
2014,KS,F,11934,921,12855,7.164527421236873
2014,KS,M,12108,3736,15844,23.579904064630146
2014,KY,F,16905,1239,18144,6.828703703703703
2014,KY,M,16864,5292,22156,23.885177829933202
2014,LA,F,19278,1399,20677,6.765971852783285
2014,LA,M,19729,5426,25155,21.570264360962035
2014,MA,F,23197,2019,25216,8.006821065989849
2014,MA,M,21693,8323,30016,27.728544776119403
2014,MD,F,22076,2088,24164,8.64095348452243
2014,MD,M,20797,7544,28341,26.61867965138845
2014,ME,F,3266,302,3568,8.464125560538116
2014,ME,M,3548,1077,4625,23.286486486486485
2014,MI,F,38695,2771,41466,6.6825833212752626
2014,MI,M,37433,11122,48555,22.905982905982906
2014,MN,F,22887,1658,24545,6.754939906294561
2014,MN,M,22039,6043,28082,21.51912256961755
2014,MO,F,24911,1914,26825,7.135135135135136
2014,MO,M,25331,6973,32304,21.585562159484894
2014,MS,F,10246,932,11178,8.337806405439256
2014,MS,M,10675,3136,13811,22.70653826659909
2014,MT,F,2747,220,2967,7.4148972025615105
2014,MT,M,3016,969,3985,24.316185696361355
2014,NC,F,41330,3552,44882,7.91408582505236
2014,NC,M,39077,12906,51983,24.82734740203528
2014,ND,F,3086,261,3347,7.798028084852106
2014,ND,M,3344,851,4195,20.28605482717521
2014,NE,F,7367,572,7939,7.204937649578033
2014,NE,M,8033,2376,10409,22.8264002305697
2014,NH,F,3384,354,3738,9.470304975922954
2014,NH,M,3352,1239,4591,26.98758440426922
2014,NJ,F,33897,3002,36899,8.135721835280089
2014,NJ,M,30738,11405,42143,27.062620126711433
2014,NM,F,6363,429,6792,6.316254416961131
2014,NM,M,6351,2716,9067,29.954781074225213
2014,NV,F,9901,698,10599,6.585526936503444
2014,NV,M,9840,3646,13486,27.03544416431855
2014,NY,F,84687,7103,91790,7.73831572066674
2014,NY,M,76193,26602,102795,25.87869059779172
2014,OH,F,48686,3669,52355,7.007926654569764
2014,OH,M,46623,13693,60316,22.70210226142317
2014,OK,F,14977,1031,16008,6.440529735132433
2014,OK,M,15500,4461,19961,22.348579730474423
2014,OR,F,14276,1072,15348,6.984623403700809
2014,OR,M,13904,4515,18419,24.512731418643792
2014,PA,F,48743,3943,52686,7.483961583722431
2014,PA,M,45510,15406,60916,25.290564055420578
2014,RI,F,2589,267,2856,9.34873949579832
2014,RI,M,2688,1195,3883,30.77517383466392
2014,SC,F,16608,1428,18036,7.917498336660013
2014,SC,M,16036,5440,21476,25.330601601788043
2014,SD,F,2876,251,3127,8.026862807803006
2014,SD,M,3269,948,4217,22.48043632914394
2014,TN,F,28447,2320,30767,7.540546689634999
2014,TN,M,27595,8693,36288,23.955577601410933
2014,TX,F,154981,10471,165452,6.328723738606968
2014,TX,M,140685,46424,187109,24.811206302208873
2014,UT,F,16664,1188,17852,6.65471655836881
2014,UT,M,16956,4418,21374,20.669972864227564
2014,VA,F,33954,3002,36956,8.123173503625933
2014,VA,M,31332,11113,42445,26.182118035104253
2014,VT,F,1136,142,1278,11.11111111111111
2014,VT,M,1346,451,1797,25.097384529771844
2014,WA,F,29038,2120,31158,6.80403106746261
2014,WA,M,27665,8703,36368,23.930378354597448
2014,WI,F,21302,1569,22871,6.860215994053605
2014,WI,M,21402,5918,27320,21.661786237188874
2014,WV,F,5719,462,6181,7.474518686296716
2014,WV,M,6141,1896,8037,23.59089212392684
2014,WY,F,1115,91,1206,7.545605306799337
2014,WY,M,1456,508,1964,25.865580448065174
